a: unit, length, equal
abandon: trait, freedom, worry
ability: quality, able, achievement
able: necessary, means, skill
aboard: plane, vehicle, first
abortion: pregnancy, failure, plan
about: move, fairly, close
above: section, written, text
abroad: foreign, country, up
absence: state, failure, present
absolute: something, relation, depend
absolutely: completely, without, used
absorb: become, take, mentally
abstract: concept, idea, associated
abuse: cruel, treatment, expression
academic: educator, college, university
academy: secondary, school, institution
accelerate: move, faster, cause
accent: distinctive, manner, oral
accept: consider, hold, true
acceptable: acceptance, up, that
acceptance: mental, attitude, something
access: right, enter, obtain
accessible: capable, read, up
accident: unfortunate, especially, one
accommodate: acceptable, make, fit
accompany: present, associated, event
accomplish: put, effect, gain
accomplishment: action, something, ability
according: go, together, allow
account: record, narrative, description
accountability: responsibility, someone, activity
accounting: explanation, basic, system
accuracy: quality, near, true
accurate: exactly, almost, fact
admit: declare, true, existence
accurately: strictly, correctly, up
accusation: formal, charge, act
accuse: bring, accusation, level
achieve: gain, effort, accomplish
achievement: action, something, accomplishment
acid: various, taste, capable
acknowledge: declare, true, admit
acquire: come, possession, something
acquisition: act, possession, something
acre: unit, area, square
across: opposite, side, come
act: legal, document, result
action: something, opposed, accomplish
active: chemical, agent, capable
actively: active, manner, up
activist: up, that, there
activity: specific, behavior, state
actor: performer, person, worker
actress: female, actor, up
actual: existing, fact, merely
actually: actual, fact, used
ad: public, promotion, product
adapt: make, fit, change
add: condition, behavioral, learning
added: make, addition, join
addition: component, added, something
additional: added, extra, up
address: code, piece, information
adequate: meet, task, sufficient
adjust: alter, regulate, achieve
adjustment: act, something, different
administer: work, administrative, charge
administration: method, group, people
administrative: responsible, administration, up
administrator: someone, business, party
admire: feel, look, up
admission: act, someone, enter
adolescent: teen, teenager, teenage
adopt: choose, take, practice
adoption: act, favorable, reception
adult: fully, developed, person
advance: movement, forward, change
advanced: move, also, sense
advantage: quality, superior, favorable
adventure: wild, exciting, necessarily
advertising: public, promotion, product
advice: proposal, appropriate, course
advise: give, advice, inform
adviser: expert, advice, consultant
advocate: person, cause, idea
aesthetic: philosophical, theory, beautiful
affair: concern, usually, sexual
affect: conscious, aspect, feeling
affiliation: social, business, relationship
affirmative: reply, optimistic, up
afford: able, spare, give
afraid: fear, regret, used
african: native, up, that
after: time, subsequent, reference
afternoon: part, day, noon
afterward: time, subsequent, reference
again: up, that, there
against: up, that, us
age: long, something, era
agency: administrative, unit, government
agenda: organized, plan, list
agent: active, efficient, capable
aggression: behave, feeling, attack
aggressive: determination, pursuit, spread
ago: past, that, there
agree: agreement, consent, something
agreement: statement, exchange, arrangement
agricultural: used, agriculture, rural
agriculture: enterprise, practice, land
ah: up, that, there
ahead: leading, position, score
aid: resource, activity, need
aide: officer, military, assistant
aids: serious, disease, immune
aim: outcome, goal, target
air: mixture, required, stuff
aircraft: vehicle, fly, up
airline: air, pressure, commercial
airplane: aircraft, fixed, wing
airport: control, tower, well
aisle: long, narrow, passage
alarm: fear, awareness, danger
album: one, originally, attractive
alcohol: active, agent, series
alien: person, foreign, someone
alike: similar, equally, like
alive: life, full, spirit
all: used, either, mass
allegation: formal, accusation, somebody
alleged: report, maintain, supposed
allegedly: according, alleged, up
alley: narrow, street, lane
alliance: state, connection, marriage
allow: make, possible, specific
ally: friendly, nation, associate
almost: slightly, short, quite
alone: isolated, lonely, entirely
along: forward, motion, companion
alongside: side, aboard, up
already: prior, time, up
also: addition, too, likewise
alter: cause, make, transformation
alternative: one, number, choice
although: that, there, this
altogether: informal, terms, complete
aluminum: element, found, primarily
always: time, every, occasion
am: degree, follow, cost
amazing: affect, wonder, mystery
ambassador: diplomat, representative, one
ambition: desire, strong, drive
ambitious: strong, desire, success
amendment: act, statement, added
american: native, language, used
amid: up, that, there
among: that, us, there
amount: quantity, money, relative
analysis: investigation, component, whole
analyst: someone, skilled, data
analyze: consider, detail, subject
ancestor: someone, usually, remote
ancient: old, person, up
and: mouth, presumably, after
angel: spiritual, upon, person
anger: strong, feeling, toward
angle: space, two, one
angry: feeling, anger, violent
animal: living, organism, voluntary
ankle: joint, end, up
anniversary: date, event, previous
announce: make, announcement, declare
announcement: formal, public, statement
annual: plant, entire, life
annually: without, missing, year
anonymous: known, name, identity
another: various, up, common
answer: statement, reply, question
anticipate: regard, something, likely
anxiety: relatively, permanent, state
anxious: anxiety, dying, nervous
any: one, every, without
anybody: up, could, that
anymore: present, usually, used
anyone: could, that, else
anything: could, that, else
anyway: used, indicate, statement
anywhere: used, up, that
apart: remote, separate, physically
apartment: suite, usually, one
apologize: acknowledge, clear, make
apology: expression, regret, trouble
apparent: clearly, mind, judgment
apparently: often, used, seemingly
appeal: request, prayer, collection
appear: give, certain, impression
appearance: visible, aspect, person
apple: fruit, red, yellow
application: act, something, particular
apply: put, make, work
appoint: create, charge, task
appointment: act, person, position
appreciate: recognize, grateful, fully
appreciation: understanding, nature, meaning
approach: deal, problem, situation
appropriate: give, assign, resource
approval: formal, act, feeling
approve: give, judge, right
approximately: fairly, close, correct
arab: member, people, originally
architect: someone, used, something
architecture: product, work, discipline
area: particular, region, boundary
arena: particular, environment, walk
argue: present, argument, something
argument: fact, evidence, something
arise: come, take, form
arm: human, part, superior
armed: prepare, military, confrontation
army: permanent, organization, military
around: area, route, approximately
arrange: put, proper, order
arrangement: thing, result, organization
array: arrangement, impressive, display
arrest: act, state, following
arrival: accomplishment, objective, act
arrive: reach, movement, progress
arrow: mark, indicate, direction
art: human, creation, beautiful
article: independent, part, publication
articulate: provide, joint, put
artifact: object, whole, up
artificial: art, rather, nature
artist: person, whose, creative
artistic: characteristic, art, aesthetic
as: element, three, used
ban: something, equal, up
ash: something, various, timber
asian: native, characteristic, culture
aside: line, actor, audience
ask: make, request, demand
asleep: state, sleep, sensation
aspect: distinct, feature, element
ass: part, human, body
assault: close, fighting, military
assemble: create, together, collect
assembly: group, machine, fit
assert: state, declare, true
assess: part, human, body
assessment: someone, something, respect
asset: useful, valuable, quality
assign: give, assignment, task
assignment: duty, perform, armed
assist: activity, need, effort
assistance: activity, need, effort
assistant: person, need, effort
associate: person, activity, friend
associated: make, logical, connection
association: formal, organization, people
assume: take, case, accept
assumption: statement, true, conclusion
assure: make, certain, inform
astronomer: up, that, there
at: highly, element, product
athlete: person, compete, up
athletic: active, up, that
atmosphere: particular, environment, surrounding
atop: top, up, that
attach: cause, contact, seize
attack: offensive, enemy, move
attempt: activity, accomplish, something
attend: present, church, take
attendance: act, present, meeting
attention: process, person, environment
attitude: complex, mental, state
attorney: professional, person, practice
attract: direct, toward, means
attraction: force, one, object
attractive: eye, mind, especially
banana: several, tropical, crown
band: association, people, including
bank: land, slope, beside
banker: executive, bank, person
banking: business, money, savings
attribute: construct, characteristic, entity
auction: variety, bridge, contract
audience: gathering, performance, part
audio: part, signal, wave
aunt: sister, father, wife
author: someone, something, source
authority: power, right, give
authorize: grant, give, power
auto: motor, vehicle, four
automatic: light, machine, gun
automatically: manner, mechanical, mechanism
automobile: motor, vehicle, four
autonomy: exercise, political, independence
availability: quality, hand, up
available: accessible, ready, use
avenue: line, approach, wide
average: location, distribution, ratio
avoid: stay, clear, keep
await: look, forward, expect
awake: stop, state, completely
award: grant, law, court
aware: knowledge, understanding, perception
awareness: knowledge, state, elementary
away: left, used, ground
awful: bad, fear, terror
baby: young, child, yet
back: part, human, body
background: social, previous, experience
backyard: back, house, up
bacteria: important, often, up
bad: standard, ethics, negative
badly: severe, serious, degree
bag: flexible, container, single
bake: cook, make, hot
balance: state, equality, credit
balanced: bring, balance, account
ball: round, object, hit
balloon: large, tough, bag
ballot: document, used, voting
bankruptcy: state, complete, lack
bar: room, establishment, counter
bare: lay, make, public
barely: short, time, way
bargain: agreement, purchase, steal
barn: farm, building, grain
barrel: tube, bullet, gun
barrier: structure, object, free
base: installation, military, force
baseball: ball, game, bat
basement: portion, structure, partly
basic: popular, programming, language
basically: bottom, nature, essentially
basin: usually, used, food
basis: relation, foundation, something
basket: container, usually, quantity
basketball: game, court, two
bat: form, turn, get
bath: vessel, liquid, something
bathroom: room, shower, usually
battery: group, missile, together
battle: hostile, meeting, military
be: light, strong, toxic
beach: area, sand, water
beam: signal, along, narrow
bean: various, family, used
bear: massive, long, strong
beard: hair, growing, lower
beast: living, organism, voluntary
beat: regular, route, policeman
beautiful: exciting, intellectual, emotional
beauty: give, pleasure, attractive
because: that, necessary, there
become: enter, assume, certain
bed: piece, furniture, place
bedroom: room, used, primarily
bee: numerous, including, social
beef: cattle, meat, adult
beer: general, name, mixture
before: previously, front, ahead
beg: call, upon, make
begin: prime, minister, peace
beginning: event, start, something
behalf: agent, part, rather
behave: certain, show, conduct
behavior: manner, action, reaction
behavioral: behavior, up, that
behind: part, human, body
being: state, fact, existing
belief: cognitive, content, true
believe: accept, take, true
bell: device, metal, sound
belly: region, body, stomach
belong: possession, suitable, acceptable
below: place, lower, later
belt: endless, loop, flexible
bench: long, seat, one
bend: segment, curve, movement
beneath: place, lower, below
benefit: financial, assistance, time
beside: up, that, along
besides: additional, anyway, addition
best: supreme, effort, one
bet: money, act, count
better: something, superior, quality
between: interval, that, us
beyond: along, space, time
bias: objective, consideration, issue
bible: sacred, book, field
bicycle: vehicle, two, foot
bid: direction, instruction, something
big: average, size, number
bike: motor, vehicle, two
billion: number, one, frequently
bind: something, stick, firmly
biography: account, series, life
biological: biology, life, living
biology: science, living, characteristic
bird: flesh, used, food
birth: time, something, event
birthday: anniversary, day, person
bishop: senior, member, spiritual
bit: small, piece, quantity
bite: wound, animal, person
bitter: term, dry, strong
bizarre: unusual, up, that
black: quality, state, color
blade: especially, leaf, grass
blame: accusation, responsible, fault
blank: character, used, separate
blanket: person, warm, bed
blast: long, fly, ball
blend: new, word, two
bless: give, happiness, sign
blessing: formal, act, state
blind: people, severe, visual
blink: rapidly, briefly, shut
block: solid, piece, something
blood: fluid, body, heart
bloody: cover, blood, damn
blow: powerful, stroke, fist
blue: color, clear, sky
board: committee, length, wide
boast: show, feature, gas
boat: small, vessel, travel
body: entire, structure, organism
boil: painful, hard, core
bold: thick, heavy, sheer
bomb: device, explode, specific
bomber: military, aircraft, flight
bombing: attack, use, tactic
bond: electrical, force, debt
bone: rigid, tissue, substance
bonus: anything, additional, payment
book: written, work, composition
boom: deep, loud, noise
boost: act, hope, support
boot: whole, foot, lower
booth: table, restaurant, two
border: line, boundary, area
boring: act, hole, earth
born: nuclear, contain, stand
borrow: get, take, practice
boss: person, control, responsible
both: count, two, that
bother: angry, something, someone
bottle: glass, plastic, vessel
bottom: lower, side, anything
bounce: quality, substance, able
boundary: line, plane, limit
bow: two, loose, used
bowl: round, vessel, open
box: may, lid, private
boy: male, person, friendly
boyfriend: man, lover, girl
brain: part, central, nervous
branch: division, complex, organization
brand: name, given, product
brave: warrior, people, gay
bread: food, dough, flour
break: ongoing, activity, unexpected
breakfast: first, meal, day
breast: front, trunk, neck
breath: process, air, breathing
breathe: draw, air, alive
breathing: process, oxygen, air
breeze: slight, wind, easy
brick: block, clay, sun
bride: woman, recently, married
bridge: structure, people, cross
brief: document, law, case
briefly: short, time, shortly
bright: light, readily, large
brilliant: unusual, impressive, intelligence
bring: take, something, somebody
british: people, characteristic, culture
broad: term, woman, great
broadcast: message, radio, television
broken: become, separate, break
broker: businessman, another, exchange
brother: male, someone, else
brown: orange, low, first
brush: dense, growth, implement
brutal: able, pain, suffering
bubble: gas, air, carbon
buck: horse, without, one
bucket: roughly, vessel, open
buddy: close, friend, brother
budget: sum, money, particular
bug: general, term, insect
build: constitution, human, body
builder: substance, added, increase
building: structure, roof, less
bulb: stem, serving, structure
bulk: property, number, two
bull: adult, male, domestic
bullet: gun, passenger, train
bunch: number, similar, informal
burden: difficult, concern, weight
bureau: administrative, unit, government
bureaucracy: government, primarily, up
burn: pain, hot, fire
burning: act, something, pain
burst: act, rapid, fit
bury: cover, sight, place
bus: vehicle, many, used
business: commercial, industrial, enterprise
businessman: person, commercial, industrial
busy: keep, actively, fully
but: nothing, simply, merely
butt: thick, end, handle
butter: fat, milk, cooking
button: round, etc, fit
buy: purchase, obtain, acquire
buyer: person, up, that
by: pass, given, point
cab: front, motor, vehicle
cabin: small, room, ship
cabinet: piece, furniture, storage
cable: abroad, electrical, electric
cafe: small, restaurant, up
cage: wire, metal, something
cake: block, solid, substance
calculate: make, calculation, judge
calculation: procedure, something, logical
calendar: system, beginning, length
call: telephone, connection, special
calm: mind, stress, wind
camera: equipment, box, lens
camp: temporary, living, army
campaign: race, office, series
campus: field, university, up
can: metal, container, food
canadian: native, river, across
canal: surface, feature, thought
cancel: previous, sharp, flat
cancer: growth, tumor, cell
candidate: politician, running, public
candle: stick, middle, basic
candy: rich, sweet, sugar
canvas: closely, fabric, clothing
cap: top, roof, capital
capability: quality, capable, physically
capable: capacity, ability, possibly
capacity: capability, perform, produce
capital: available, use, production
captain: officer, rank, major
capture: act, owner, property
car: motor, vehicle, four
carbon: element, three, organic
card: one, set, small
care: work, treatment, someone
career: particular, occupation, general
careful: care, attention, up
carefully: care, attention, kid
carrier: someone, whose, employment
carrot: deep, orange, root
carry: act, something, move
cart: heavy, open, wagon
cartoon: drawing, newspaper, magazine
carve: form, cut, away
case: something, special, set
cash: money, form, prompt
casino: public, building, entertainment
cast: play, container, liquid
castle: large, mansion, building
casual: without, plan, occasional
casualty: someone, missing, military
cat: usually, thick, soft
catalog: book, complete, list
catch: difficulty, readily, evident
category: collection, common, attribute
catholic: member, church, that
cattle: group, regardless, sex
cause: provide, force, origin
cave: formation, access, surface
cease: phrase, end, put
ceiling: upper, surface, space
celebrate: behave, expected, celebration
celebration: occasion, special, mark
celebrity: widely, known, person
cell: small, basic, structural
cemetery: land, used, up
census: count, population, conduct
center: area, approximately, central
central: workplace, facility, together
century: period, ten, hundred
ceremony: formal, event, special
certain: feeling, doubt, confident
certainly: definitely, sometimes, used
chain: series, depending, together
chair: seat, one, support
chairman: officer, organization, act
challenge: situation, call, engage
chamber: natural, artificial, space
champion: someone, first, place
championship: status, champion, competition
chance: possibility, due, favorable
change: event, something, one
changing: cause, make, transformation
channel: path, electrical, pass
chaos: state, extreme, confusion
chapter: written, usually, distinct
character: person, work, fiction
characteristic: prominent, attribute, aspect
characterize: describe, portray, character
charge: rush, toward, someone
charity: foundation, promote, public
charm: verbal, formula, force
chart: visual, display, information
charter: document, institution, contract
chase: act, effort, capture
cheap: relatively, low, price
cheat: annual, grass, often
check: written, order, bank
cheek: either, side, face
cheer: cry, shout, approval
cheese: solid, food, milk
chef: professional, cook, up
chemical: material, used, reaction
chemistry: science, branch, natural
chest: part, human, neck
chew: something, tobacco, food
chicken: flesh, used, food
chief: person, charge, control
child: young, person, either
childhood: time, life, child
chill: due, cold, environment
chin: part, lower, jaw
chinese: single, language, though
chip: small, fragment, something
chocolate: powder, milk, usually
choice: person, thing, act
cholesterol: animal, normally, up
choose: pick, number, select
chop: motion, wind, direction
christian: religious, person, member
christianity: system, role, collective
christmas: period, holiday, birth
chronic: long, suffering, continuing
chunk: mass, substantial, amount
church: one, place, public
cigarette: ground, tobacco, smoking
circle: two, equal, plane
circuit: electrical, device, path
circumstance: condition, event, activity
cite: short, note, source
citizen: native, member, state
citizenship: status, citizen, conduct
city: large, urban, may
civic: city, civil, up
civil: ordinary, military, especially
civilian: citizen, associated, civil
civilization: society, advanced, state
claim: right, money, something
class: collection, common, attribute
classic: creation, artist, classical
classical: traditional, genre, music
classify: arrange, order, declare
classroom: room, school, take
clay: soil, plastic, hard
clean: shoulder, height, make
clear: state, free, suspicion
clearly: without, doubt, question
clerk: employee, work, store
click: short, light, sound
client: person, advice, lawyer
cliff: steep, high, face
climate: weather, location, long
climb: slope, grade, event
cling: fruit, whose, flesh
clinic: medical, establishment, run
clinical: clinic, depending, direct
clip: metal, frame, container
clock: time, day, measure
close: time, last, section
closed: move, opening, passage
closely: close, relation, position
closer: person, something, relief
closest: within, short, distance
closet: small, room, cabinet
cloth: artifact, natural, material
clothes: clothing, general, provide
clothing: body, provide, clothes
cloud: collection, smoke, visible
club: team, professional, baseball
clue: slight, indication, evidence
cluster: number, similar, come
coach: someone, charge, training
coal: fuel, vegetable, matter
coalition: organization, people, involved
coast: shore, sea, ocean
coastal: coast, near, up
coat: outer, body, shoulder
cocaine: used, surface, become
code: set, written, system
coffee: ground, several, small
cognitive: up, that, there
coin: flat, metal, piece
cold: mild, infection, nose
collaboration: act, working, enemy
collapse: failure, function, complete
collar: band, around, neck
colleague: associate, one, person
collect: short, prayer, generally
collection: several, together, whole
collective: cooperative, enterprise, characteristic
collector: person, collect, rent
college: body, faculty, institution
colonel: military, officer, lieutenant
colonial: resident, colony, characteristic
colony: body, people, settle
color: visual, attribute, light
colorful: striking, color, variety
column: line, following, one
columnist: journalist, up, that
combat: engagement, two, military
combination: collection, separate, sequence
combine: grain, across, field
combined: possess, combination, put
come: thick, white, fluid
comedy: light, drama, happy
comfort: state, feeling, pain
comfortable: physical, relief, free
coming: act, drawing, closer
command: direction, instruction, something
commander: officer, command, military
comment: statement, personal, opinion
commerce: objective, federal, department
commercial: ad, radio, television
commission: special, group, consider
commissioner: government, administrator, member
commit: perform, usually, negative
commitment: trait, purpose, act
committee: special, group, consider
commodity: commerce, good, up
common: piece, open, land
commonly: normal, normally, usually
communicate: transmit, information, convey
communication: activity, information, up
communist: member, party, up
community: group, people, living
companion: friend, frequently, company
company: institution, conduct, business
comparable: able, comparison, every
compare: comparable, examine, note
comparison: act, relation, compare
compel: force, somebody, something
compelling: force, somebody, something
compensation: something, given, payment
compete: engage, measure, contend
competition: business, relation, two
competitive: competition, up, that
competitor: hope, defeat, rival
complain: express, make, formal
complaint: often, disorder, cause
complete: come, bring, finish
completely: complete, degree, full
complex: whole, complicated, related
complexity: quality, up, that
compliance: according, certain, tendency
complicated: make, elaborate, up
comply: act, follow, up
component: abstract, part, something
compose: form, substance, write
composition: property, arrangement, relation
compound: whole, union, two
comprehensive: examination, testing, special
comprise: include, component, contain
compromise: middle, way, two
computer: machine, automatically, expert
concede: admit, willing, grant
conceive: idea, judge, look
concentrate: mineral, left, form
concentration: strength, number, substance
concept: abstract, general, idea
conception: abstract, general, idea
concern: something, important, anxious
concerned: relevant, mind, refer
concerning: relevant, mind, refer
concert: performance, music, mutual
conclude: decide, draw, come
conclusion: position, opinion, judgment
concrete: strong, hard, building
condemn: express, strong, declare
condition: state, particular, time
conduct: manner, way, person
conference: meeting, exchange, information
confess: usually, pressure, admit
confession: admission, written, document
confidence: freedom, belief, feeling
confident: confidence, sure, convinced
confirm: establish, strengthen, new
conflict: open, two, opposition
confront: competition, deal, head
confrontation: bold, challenge, opposition
confuse: mistake, one, thing
confusion: disorder, failure, behave
congress: legislature, government, meeting
congressional: congress, up, that
congressman: member, representative, up
connect: put, together, two
connection: relation, case, one
conscience: motivation, ethical, moral
conscious: awareness, up, that
consciousness: cognitive, state, aware
consensus: agreement, judgment, opinion
consent: permission, something, give
consequence: phenomenon, previous, effect
consequently: reason, given, consequence
conservation: improvement, virtue, loss
conservative: person, reluctant, accept
consider: deem, give, careful
considerable: large, relatively, number
considerably: great, extent, degree
consideration: process, careful, thought
consist: essential, comprise, lie
consistent: agreement, capable, logical
consistently: consistent, manner, up
conspiracy: secret, agreement, two
constant: quantity, vary, number
constantly: without, variation, every
constitute: form, compose, create
constitution: law, fundamental, political
constitutional: regular, walk, form
constraint: state, physically, device
construct: abstract, general, idea
construction: act, something, group
consult: get, ask, advice
consultant: expert, advice, adviser
consume: eat, serve, regularly
consumer: person, goods, up
consumption: process, food, body
contact: close, interaction, act
contain: include, component, within
container: object, used, hold
contemplate: look, observe, deep
contemporary: person, nearly, age
contend: maintain, assert, argument
content: everything, collection, something
contest: occasion, winner, among
context: discourse, language, unit
continent: one, large, earth
continue: certain, activity, proceed
continued: continue, certain, activity
continuing: continue, certain, activity
continuous: continuing, time, space
contract: agreement, two, law
contractor: someone, person, build
contrast: opposition, act, line
contribute: quality, cause, lead
contribution: part, person, result
control: power, direct, determine
controversial: capable, controversy, up
controversy: speech, dispute, strong
convenience: state, suitable, quality
convention: large, formal, assembly
conventional: following, formal, up
conversation: use, speech, informal
conversion: event, transformation, change
convert: person, another, religious
convey: make, pass, information
convict: person, serving, sentence
conviction: belief, something, without
convince: make, realize, truth
convinced: make, realize, truth
cook: someone, food, east
cookie: various, small, flat
cooking: act, something, application
cool: quality, low, temperature
cooperate: work, together, common
cooperation: joint, operation, action
cooperative: commercial, enterprise, organized
coordinate: number, position, relative
coordinator: someone, whose, task
cop: terms, policeman, take
cope: brick, top, wall
copy: written, record, legal
cord: line, unit, amount
core: small, group, center
corn: tall, annual, grass
corner: place, side, area
corporate: corporation, existing, collective
corporation: business, firm, whose
corps: army, unit, usually
correct: make, right, set
correction: act, offering, improvement
correctly: accurate, manner, right
correlation: relation, two, closely
correspondent: someone, means, journalist
corridor: usually, open, onto
corruption: lack, integrity, use
cost: total, goods, including
costly: great, loss, sacrifice
costume: play, dress, ball
cottage: small, house, single
cotton: soft, raw, state
couch: seat, one, person
could: use, anything, now
council: body, serving, administrative
counsel: lawyer, court, something
counseling: something, direction, advice
counselor: someone, advice, summer
count: total, number, act
counter: table, surface, business
counterpart: person, thing, function
country: politically, organized, body
county: region, division, purpose
coup: sudden, change, government
couple: pair, associate, one
courage: quality, spirit, face
course: education, series, grade
court: assembly, one, conduct
courtesy: act, remark, up
courtroom: room, court, up
cousin: child, aunt, uncle
cover: shelter, something, person
coverage: total, amount, type
cow: female, domestic, male
cowboy: hand, cattle, performer
crack: long, narrow, opening
craft: skilled, practice, practical
crash: loud, noise, serious
crawl: slow, movement, swimming
crazy: someone, possibly, dangerous
cream: best, people, group
create: make, cause, become
creation: human, act, artifact
creative: ability, power, create
creativity: ability, create, up
creature: living, organism, voluntary
credibility: quality, up, that
credit: approval, money, available
creek: natural, stream, water
crew: man, vehicle, organized
crime: act, usually, evil
criminal: someone, crime, legally
crisis: situation, extreme, danger
criteria: basis, reference, point
critic: person, analysis, interpretation
critical: tendency, find, call
criticism: serious, examination, judgment
criticize: find, fault, express
crop: yield, single, growing
cross: wooden, structure, post
crowd: large, number, people
crowded: cause, crowd, together
crown: symbol, power, authority
crucial: extreme, vital, resolution
cruel: able, pain, suffering
cruise: ocean, trip, pleasure
crush: leather, grain, pattern
cry: loud, often, protest
crystal: solid, chemical, highly
cuban: native, characteristic, people
cue: line, immediately, reminder
cultural: group, distinctive, living
culture: particular, society, time
cup: small, open, container
cure: medicine, therapy, disease
curiosity: state, want, learn
curious: beyond, usual, expected
currency: metal, paper, medium
current: flow, electricity, steady
currently: time, up, that
curriculum: integrated, course, academic
curtain: cloth, used, blind
curve: trace, point, whose
custody: state, short, police
custom: practice, specific, long
customer: someone, goods, client
cut: share, immediate, transition
cute: attractive, especially, means
cycle: interval, sequence, series
dad: informal, term, probably
daddy: informal, term, probably
daily: newspaper, every, day
dam: barrier, contain, flow
damage: change, loss, military
damn: something, little, value
dance: artistic, form, communication
dancer: performer, person, social
dancing: series, time, music
danger: condition, harm, injury
dangerous: danger, hurt, harm
dare: challenge, something, dangerous
dark: absence, light, moral
darkness: absence, light, area
data: collection, may, item
database: organized, body, related
date: day, month, participant
daughter: female, human, girl
dawn: first, light, day
day: time, make, complete
dead: people, living, time
deadline: point, time, something
deadly: capable, death, instrument
deal: particular, instance, agreement
dealer: someone, inventory, goods
dear: used, terms, sweet
death: event, dying, departure
debate: discussion, advanced, proposition
debris: something, broken, dust
debt: state, something, money
debut: act, beginning, something
decade: period, number, sum
decent: socially, according, custom
decide: come, decision, something
decision: act, mind, something
deck: various, vessel, street
declaration: statement, explicit, evidence
declare: state, announce, publicly
decline: change, toward, something
decorate: make, attractive, beautiful
decrease: change, process, reduction
dedicate: give, entirely, specific
deem: keep, mind, convey
deep: central, intense, profound
deeper: relatively, deep, one
deeply: great, depth, deep
deer: solid, up, that
defeat: struggle, contest, feeling
defend: argue, speak, defense
defendant: person, institution, action
defender: person, property, fighter
defense: military, action, country
defensive: attitude, phrase, appropriate
deficit: property, amount, something
define: determine, essential, quality
definitely: without, question, beyond
definition: explanation, meaning, word
degree: position, scale, intensity
delay: time, action, act
deliberately: manner, up, that
delicate: fine, subtle, injury
delight: feeling, extreme, pleasure
deliver: bring, make, delivery
delivery: act, something, goods
demand: request, ability, desire
democracy: political, orientation, favor
democrat: member, advocate, democratic
democratic: upon, democracy, social
demographic: human, broken, age
demonstrate: give, exhibition, interested
demonstration: show, act, something
denial: act, comply, something
dense: little, light, pass
density: amount, unit, size
deny: declare, refuse, accept
depart: move, away, place
department: division, large, organization
departure: act, variation, standard
depend: upon, faith, confidence
dependent: person, another, support
depending: upon, faith, confidence
depict: show, picture, give
deploy: place, troops, battle
deposit: phenomenon, matter, natural
depressed: lower, make, low
depression: mental, state, sense
depth: extent, degree, psychological
deputy: someone, exercise, sheriff
derive: reason, establish, obtain
descend: move, necessarily, way
describe: give, description, account
description: statement, something, act
desert: land, little, leave
deserve: merit, up, that
design: act, working, form
designer: person, someone, used
desire: feeling, state, want
desk: piece, furniture, writing
desperate: person, need, help
desperately: great, intense, up
despite: lack, respect, feeling
dessert: dish, last, course
destination: place, end, race
destroy: away, cause, destruction
destruction: something, much, damage
detail: isolated, fact, whole
detailed: provide, assign, specific
detect: discover, determine, fact
detective: police, officer, investigator
determination: act, usually, research
determine: establish, study, shape
devastating: cause, extensive, destruction
develop: make, something, product
developed: make, something, product
developer: someone, real, estate
developing: processing, material, order
development: act, process, something
developmental: development, up, that
device: particular, purpose, something
devil: chief, spirit, evil
devise: real, property, gift
devote: give, entirely, specific
diabetes: disease, high, several
diagnose: determine, distinguish, nature
diagnosis: nature, cause, phenomenon
diagram: drawing, explain, something
dialogue: conversation, two, drama
diamond: piece, cut, precious
diary: daily, written, record
dictate: rule, principle, order
die: small, six, used
diet: selection, legislative, assembly
differ: different, disagree, up
difference: quality, unlike, variation
different: unlike, nature, quality
differently: another, different, manner
difficult: great, physical, mental
difficulty: effort, factor, trouble
dig: site, exploration, aggressive
digital: rather, scale, up
dignity: quality, respect, appearance
dilemma: state, uncertainty, especially
dimension: magnitude, something, particular
diminish: decrease, range, reputation
dining: act, eating, dinner
dinner: main, meal, day
dip: depression, otherwise, level
diplomat: official, international, person
diplomatic: characteristic, sensitive, people
direct: command, authority, intend
direction: line, leading, place
directly: without, anyone, anything
director: someone, member, board
dirt: part, surface, rock
dirty: make, likely, soil
disability: condition, unable, perform
disabled: people, otherwise, physically
disagree: different, one, another
disappear: get, without, warning
disappointed: fail, meet, up
disappointment: feeling, act, failure
disaster: state, extreme, ruin
discipline: branch, knowledge, system
disclose: make, known, public
discount: act, price, interest
discourage: try, show, opposition
discourse: extended, verbal, expression
discover: determine, fact, get
discovery: act, something, find
discrimination: unfair, treatment, person
discuss: athletic, competition, object
discussion: extended, communication, particular
disease: health, condition, up
dish: piece, normally, used
disk: something, round, shape
dismiss: bar, attention, consideration
disorder: physical, condition, normal
display: something, communicate, particular
dispute: argument, something, important
dissolve: transition, one, scene
distance: property, space, two
distant: space, coming, distance
distinct: different, nature, quality
distinction: discrimination, different, distinct
distinctive: feature, distinguish, person
distinguish: mark, different, detect
distract: draw, attention, away
distribute: administer, small, widely
distribution: arrangement, variable, theoretical
district: region, administrative, regulate
disturb: move, deeply, change
disturbing: move, deeply, change
diverse: many, different, unlike
diversity: condition, result, variety
divide: serious, two, people
divine: terms, person, religious
division: army, unit, large
divorce: legal, marriage, cease
do: party, first, note
doctor: medical, practitioner, title
doctrine: belief, system, group
document: writing, information, official
documentary: film, program, person
dog: member, common, man
doll: small, used, toy
dollar: basic, unit, many
domain: particular, environment, walk
domestic: servant, perform, around
dominant: fifth, note, scale
dominate: status, importance, control
donate: give, charity, good
due: payment, price, up
donation: voluntary, gift, money
donor: person, gift, property
door: barrier, close, entrance
doorway: entrance, space, enter
dose: portion, medicine, one
dot: small, shape, federal
double: base, hit, safely
doubt: state, something, uncertainty
dough: flour, mixture, stiff
down: soft, fine, complete
downtown: central, area, commercial
dozen: number, sum, eleven
draft: document, payment, one
drag: phenomenon, resistance, motion
drain: something, liquid, run
drama: dramatic, work, performance
dramatic: suitable, characteristic, drama
dramatically: impressive, manner, dramatic
draw: large, lot, pull
drawer: container, piece, slide
drawing: illustration, hand, newspaper
dream: series, mental, sleep
dress: skirt, clothing, distinctive
dried: remove, make, dry
drift: force, something, along
drink: single, serving, act
drinking: act, drink, up
drive: act, force, something
driver: operator, motor, vehicle
driveway: road, leading, private
driving: golf, ball, driver
drop: shape, small, quantity
drown: cover, completely, make
drug: substance, used, medicine
drum: musical, usually, across
drunk: chronic, someone, drink
dry: use, remove, make
duck: small, wild, swimming
dumb: slow, learn, intellectual
dump: term, piece, land
during: up, that, there
dust: fine, material, dry
dutch: people, language, up
duty: social, force, action
dying: time, something, pass
dynamic: efficient, incentive, action
dynamics: branch, concerned, cause
each: count, every, one
eager: high, wave, flow
eagle: various, large, broad
ear: sense, organ, hearing
early: near, beginning, period
earn: commercial, business, salary
earnings: given, period, time
earth: planet, live, ground
earthquake: surface, earth, movement
ease: freedom, difficulty, effort
easily: ease, sometimes, used
east: point, that, there
eastern: toward, east, characteristic
easy: little, effort, loose
eat: take, solid, food
eating: act, food, take
echo: sound, reflection, repeat
ecological: living, environment, science
economic: system, production, management
economically: respect, economic, science
economics: branch, social, science
economist: expert, science, economics
economy: system, production, distribution
edge: boundary, surface, line
edit: prepare, publication, presentation
edition: form, text, identical
editor: person, responsible, final
educate: give, education, create
education: knowledge, skill, learning
educational: process, education, knowledge
educator: someone, young, people
effect: phenomenon, previous, issue
effective: capable, result, striking
effectively: effective, manner, reality
effectiveness: power, quality, able
efficiency: ratio, output, input
efficient: effective, without, time
effort: activity, accomplish, something
egg: animal, body, together
ego: feeling, pride, consciousness
eight: number, sum, seven
eighth: position, eight, series
either: negative, statement, used
elaborate: add, account, meaning
elbow: joint, upper, arm
elder: person, numerous, small
elderly: people, old, advanced
elect: exclusive, group, people
election: vote, select, winner
electric: car, electricity, electrical
electrical: concerned, electricity, electric
electricity: physical, phenomenon, associated
electronic: concerned, operate, behavior
electronics: branch, physics, emission
elegant: appearance, behavior, style
element: abstract, part, something
elementary: easy, involved, complicated
elephant: symbol, up, that
elevator: device, platform, cage
eleven: number, sum, ten
eligible: up, that, there
eliminate: take, away, reject
elite: group, class, superior
else: anything, could, that
elsewhere: another, place, up
embarrassed: cause, feel, block
embassy: diplomatic, building, live
embrace: act, another, person
emerge: come, issue, up
emergency: sudden, crisis, immediate
emerging: come, issue, emerge
emission: act, flow, forth
emotion: strong, feeling, up
emotional: emotion, rather, reason
emotionally: emotional, manner, regard
emphasis: special, importance, significance
emphasize: single, important, give
empire: domain, region, group
employ: state, job, put
employee: worker, perform, job
employer: person, firm, up
employment: state, job, occupation
empty: container, make, abandon
enable: render, capable, able
enact: order, virtue, superior
encounter: minor, fight, casual
encourage: contribute, progress, growth
encouraging: contribute, progress, growth
end: either, something, length
endless: seemingly, without, end
endorse: approve, give, support
endure: put, something, somebody
enemy: military, force, armed
energy: quantity, equivalent, capacity
enforce: ensure, compel, behave
enforcement: act, up, that
engage: carry, participate, involved
engagement: hostile, meeting, military
engine: motor, energy, mechanical
engineer: person, scientific, knowledge
engineering: practical, application, science
english: language, official, side
enhance: increase, make, better
enjoy: derive, receive, pleasure
enormous: large, size, extent
enough: adequate, quantity, large
ensure: make, certain, careful
enter: come, go, become
enterprise: one, effort, organization
entertain: provide, entertainment, take
entertainment: activity, attention, up
enthusiasm: feeling, excitement, eager
entire: adult, male, horse
entirely: complete, degree, full
entitle: give, right, title
entity: perceived, known, distinct
entrance: something, access, get
entrepreneur: someone, business, venture
entry: item, written, record
envelope: flat, container, thin
environment: surrounding, area, something
environmental: external, concerned, ecological
envision: conceive, see, mind
epidemic: widespread, many, people
episode: distinctive, series, related
equal: person, standing, another
equality: quality, quantity, measure
equally: degree, equal, balanced
equation: statement, two, equal
equip: provide, usually, specific
equipment: perform, service, automatic
equity: difference, market, value
equivalent: person, thing, equal
era: period, distinctive, character
error: wrong, action, bad
escape: act, physically, retreat
especially: extent, degree, common
essay: literary, composition, attempt
essence: essential, vital, part
essential: anything, absolutely, necessary
essentially: bottom, nature, basically
establish: set, found, lay
establishment: act, something, organization
estate: everything, real, property
estimate: calculation, quantity, degree
estimated: judge, form, estimate
etc: up, that, there
ethical: philosophical, study, ethics
ethics: motivation, right, wrong
ethnic: person, member, group
european: native, characteristic, people
evaluate: estimate, significance, form
evaluation: act, value, worth
eve: wife, first, woman
even: latter, part, day
evening: latter, part, day
event: something, given, place
eventually: period, time, especially
ever: time, every, occasion
every: count, group, without
everybody: up, that, else
everyday: found, ordinary, course
everyone: up, that, else
everything: that, else, there
everywhere: used, up, that
evidence: basis, belief, knowledge
evident: clearly, mind, judgment
evil: behavior, harm, destruction
evolution: process, something, different
evolve: work, undergo, development
exact: claim, due, take
exactly: precisely, just, up
exam: set, skill, knowledge
examination: act, something, closely
examine: consider, detail, subject
example: item, information, typical
exceed: scope, size, standard
excellent: quality, up, that
except: take, exception, prevent
exception: act, instance, rule
excessive: beyond, normal, especially
exchange: chemical, process, one
excited: feeling, act, charge
excitement: feeling, joy, state
exciting: feeling, act, charge
exclude: prevent, shut, except
exclusive: news, report, first
exclusively: without, involved, entirely
excuse: defense, offensive, behavior
execute: kill, means, socially
execution: person, death, act
executive: person, responsible, administration
exercise: activity, various, keep
exhaust: engine, waste, system
exhibit: object, statement, court
exhibition: act, collection, art
exist: support, survive, live
existence: state, fact, existing
existing: support, survive, exist
exit: opening, escape, release
exotic: characteristic, another, place
expand: extend, one, become
expansion: act, increasing, size
expect: regard, something, likely
expectation: belief, mental, picture
expected: regard, something, likely
expedition: military, campaign, achieve
expense: goods, may, currently
expensive: high, price, up
experience: knowledge, skill, direct
experienced: go, live, knowledge
experiment: act, test, investigation
experimental: experiment, observation, up
expert: person, special, knowledge
expertise: virtue, special, knowledge
explain: make, plain, define
explanation: statement, something, relevant
explicit: precisely, clearly, readily
explode: cause, burst, violent
exploit: achievement, use, manipulate
exploration: travel, purpose, discovery
explore: travel, search, research
explosion: violent, release, energy
export: foreign, country, sell
expose: exposure, fraud, make
exposure: action, heat, cold
express: mail, rapid, efficient
expression: face, without, aspect
extend: scope, range, area
extended: extend, scope, range
extension: delay, date, set
extensive: large, extent, range
extent: point, degree, something
external: outside, beyond, especially
extra: minor, actor, crowd
extraordinary: beyond, ordinary, highly
extreme: degree, something, point
extremely: high, degree, much
eye: organ, sight, good
eyebrow: hair, eye, up
fabric: artifact, natural, underlying
face: front, human, head
facilitate: make, use, help
facility: building, place, particular
fact: piece, information, exist
factor: anything, result, abstract
factory: plant, one, manufacturing
faculty: one, inherent, cognitive
fade: golf, shot, right
fail: leave, something, break
failure: act, event, accomplish
faint: loss, consciousness, blood
fair: skill, gathering, promote
fairly: sufficient, extent, degree
faith: strong, belief, power
fall: season, sudden, drop
false: fact, reality, error
fame: state, quality, widely
familiar: person, household, high
family: social, unit, living
famous: widely, known, up
fan: device, current, air
fantastic: odd, good, great
fantasy: imagination, reality, fiction
far: terrorist, organization, government
fare: agenda, sum, public
farm: workplace, land, unit
farmer: person, farm, civil
fascinating: cause, interested, curious
fashion: something, characteristic, practice
fast: food, certain, religious
faster: capable, quickly, time
fat: soft, substance, organic
fatal: death, black, up
fate: event, course, inevitably
father: male, parent, used
fatigue: temporary, loss, strength
fault: wrong, action, bad
favor: act, advantage, benefit
favorable: encouraging, promote, facilitate
favorite: something, special, favor
fear: emotion, experienced, specific
feather: light, structure, external
feature: prominent, attribute, aspect
federal: member, officer, jurisdiction
federation: organization, several, union
fee: fixed, charge, privilege
feed: food, domestic, provide
feedback: process, part, output
feel: general, atmosphere, place
feeling: emotional, idea, confidence
fellow: boy, man, friend
female: animal, male, person
fit: display, bad, sudden
feminist: supporter, equal, up
fence: barrier, area, dealer
festival: day, period, time
fever: rise, temperature, frequently
few: small, elite, group
fewer: used, count, meaning
fiber: greatly, substance, capable
fiction: literary, work, imagination
field: piece, land, usually
fierce: extreme, violent, energy
fifteen: number, sum, one
fifth: quantity, equal, one
fifty: number, product, ten
fight: hostile, meeting, military
fighter: someone, military, naval
fighting: act, contest, struggle
figure: diagram, picture, material
file: set, related, written
fill: quantity, sufficient, satisfy
film: form, entertainment, story
filter: device, something, whatever
final: match, previous, tournament
finally: period, time, especially
finance: commercial, activity, capital
financial: fiscal, assistance, condition
find: productive, insight, act
finding: act, usually, research
fine: money, penalty, issue
finger: hand, length, used
finish: texture, appearance, surface
fire: event, something, burning
firm: business, organization, one
firmly: determination, secure, manner
first: series, element, low
fiscal: financial, that, there
fish: various, mostly, usually
fisherman: someone, whose, occupation
fishing: act, someone, occupation
fist: hand, up, that
fitness: quality, suitable, good
five: number, sum, four
fix: informal, terms, difficult
fixed: restore, part, together
flag: usually, piece, cloth
flame: process, heat, light
flash: sudden, intense, burst
flat: level, land, shallow
flavor: general, atmosphere, place
flee: run, away, quickly
fleet: group, aircraft, operating
flesh: soft, tissue, body
flexibility: property, easily, quality
flexible: capable, able, bend
flight: formation, aircraft, instance
flip: roll, head, forward
float: time, interval, deposit
flood: body, water, onto
floor: inside, lower, surface
flour: fine, meal, grain
flow: motion, characteristic, amount
flower: plant, organ, especially
fluid: substance, room, temperature
fly: active, flight, piece
flying: instance, air, travel
focus: concentration, attention, energy
fog: water, air, near
fold: shape, group, people
folk: people, general, used
follow: travel, go, come
following: group, act, effort
food: substance, animal, give
fool: person, good, judgment
foot: part, leg, human
football: various, ball, two
for: assistance, anything, expression
forbid: command, keep, make
force: powerful, effect, influence
forehead: part, face, large
foreign: concern, concerning, characteristic
foreigner: person, foreign, someone
forest: large, area, land
forever: long, seemingly, endless
forget: dismiss, stop, unable
forgive: stop, grant, payment
fork: used, serving, eating
form: sound, appearance, word
formal: dance, evening, wear
format: organization, information, according
formation: arrangement, people, unit
former: first, two, late
formerly: previous, time, once
formula: group, make, statement
forth: river, southern, particular
fortunately: good, fortune, up
fortune: unknown, phenomenon, event
forty: number, product, ten
forum: public, meeting, assembly
forward: person, position, certain
foster: whose, sentiment, promote
found: food, provided, addition
foundation: basis, something, institution
founder: tissue, foot, horse
four: number, sum, three
fourth: following, third, number
fraction: component, mixture, process
fragile: easily, broken, delicate
fragment: piece, broken, cut
frame: framework, pair, single
framework: description, complex, entity
franchise: sell, goods, particular
frankly: case, up, that
fraud: injury, another, person
free: people, grant, freedom
freedom: condition, power, act
freely: free, manner, up
freeze: withdrawal, heat, change
french: language, people, up
frequency: number, within, given
frequent: shopping, business, customer
frequently: many, short, often
fresh: recently, beginning, wise
freshman: undergraduate, new, participant
friend: person, know, well
friendly: troops, military, characteristic
friendship: state, up, that
from: assistance, period, request
front: side, forward, prominent
frontier: wilderness, edge, area
frozen: stop, become, change
fruit: body, seed, plant
frustrate: prevent, treat, cross
frustration: feeling, experience, act
fuel: substance, produce, energy
full: time, fully, beat
fully: greatest, degree, completely
fun: verbal, expense, play
function: relation, element, given
functional: capable, particular, function
fund: reserve, money, set
fundamental: factor, could, important
funding: financial, provided, make
funeral: ceremony, dead, person
funny: account, incident, punch
fur: coat, dense, fine
furniture: make, room, area
furthermore: addition, moreover, up
future: time, yet, come
gain: quantity, added, quality
galaxy: famous, herb, tiny
gallery: golf, tennis, match
gallon: liquid, unit, equal
game: contest, determine, winner
gang: association, informal, body
gap: difference, two, open
garage: part, housing, repair
garbage: food, message, refuse
garden: plot, ground, up
garlic: herb, southern, widely
gas: state, matter, solid
gasoline: mixture, used, mainly
gate: barrier, fence, wall
gather: small, tight, thread
gathering: group, together, one
gay: someone, sexual, attraction
gaze: long, fixed, look
gear: wheel, another, mechanism
gender: category, agreement, quite
gene: segment, involved, include
general: officer, rank, head
generally: rule, without, distinction
generate: bring, existence, give
generation: people, living, time
generous: willing, give, share
genetic: among, family, usually
genius: someone, intellectual, ability
genre: kind, literary, artistic
gentle: cause, gain, good
gentleman: man, personal, employer
gently: manner, gentle, softly
genuine: true, real, actual
german: person, standard, developed
gesture: motion, body, emphasize
get: return, shot, impossible
ghost: mental, representation, experience
giant: creature, size, person
gift: something, without, compensation
girl: young, woman, female
girlfriend: female, friend, girl
give: something, original, length
given: assumption, cause, abstract
glad: numerous, native, tropical
glance: quick, look, throw
glass: solid, structure, container
glimpse: quick, look, brief
global: entire, limited, scope
globe: planet, live, ball
glory: state, high, honor
glove: used, baseball, hand
go: time, working, someone
goal: state, plan, achieve
goat: numerous, related, sheep
god: perfect, object, part
gold: deep, yellow, color
golden: deep, slightly, color
golf: game, large, open
good: benefit, moral, just
goods: benefit, moral, commodity
gospel: four, tell, story
govern: bring, impose, direct
government: organization, authority, political
governor: head, state, government
grab: mechanical, device, object
grade: body, together, relative
gradually: manner, up, that
graduate: person, degree, school
graduation: successful, program, study
grain: relatively, small, particle
gram: unit, weight, equal
grand: number, product, piano
grandchild: child, son, daughter
grandfather: father, mother, up
grandmother: mother, father, up
grant: aid, act, subsidy
grape: various, fruit, green
graph: visual, representation, certain
grasp: understanding, nature, meaning
grass: green, used, cut
grateful: feeling, comfort, pleasure
grave: death, person, place
gravity: force, attraction, especially
gray: neutral, color, white
great: person, distinction, honor
greatest: quality, relatively, large
greatly: extraordinary, extent, degree
greek: branch, family, native
green: color, growing, grass
greet: express, upon, meeting
grief: intense, loss, one
grill: restaurant, food, framework
grin: expression, usually, pleasure
grip: act, object, order
grocery: marketplace, consumer, goods
gross: twelve, dozen, entire
ground: solid, part, surface
group: number, unit, two
grow: pass, condition, take
growing: process, individual, organism
growth: process, individual, organism
guarantee: written, product, service
guard: person, watch, something
guess: message, opinion, evidence
guest: visitor, extended, journalist
guidance: something, direction, advice
guide: someone, conduct, way
guideline: light, line, used
guilt: state, offense, feeling
guilty: responsible, act, sense
guitar: instrument, usually, six
gulf: arm, sea, ocean
gun: weapon, missile, high
gut: part, canal, stomach
guy: informal, term, youth
gym: athletic, facility, physical
habit: custom, automatic, pattern
habitat: type, environment, organism
hair: body, dense, growth
half: one, two, equal
halfway: equally, distant, point
hall: interior, passage, corridor
hallway: interior, passage, corridor
hammer: part, cap, trigger
hand: superior, limb, farm
handful: small, number, amount
handle: object, order, use
handsome: appearance, especially, reason
hang: special, way, something
happen: come, pass, case
happily: manner, lucky, way
happiness: state, intense, joy
happy: joy, pleasure, good
harassment: feeling, intense, act
harbor: port, take, place
hard: great, physical, mental
harder: great, physical, mental
hardly: short, time, almost
hardware: major, military, metal
harm: physical, damage, body
harmony: opinion, action, structure
harsh: rough, up, that
hat: head, bad, crown
hate: emotion, intense, feeling
haul: act, drawing, something
have: person, great, material
hazard: source, possibility, loss
he: light, element, one
head: upper, part, human
headache: something, someone, source
headline: newspaper, article, widely
headquarters: office, administrative, center
heal: recover, get, healthy
health: healthy, state, free
healthy: good, health, body
hear: perceive, via, sense
hearing: evidence, purpose, issue
heart: organ, behind, move
heat: form, energy, difference
heaven: place, complete, delight
heavily: considerable, degree, manner
heavy: actor, serious, role
heel: bottom, shoe, back
height: vertical, dimension, distance
helicopter: aircraft, without, lift
hell: place, pain, cause
hello: expression, hi, up
helmet: plate, head, protective
help: activity, need, effort
helpful: assistance, serving, useful
hence: introduce, logical, fact
her: under, hair, mouth
herb: plant, permanent, many
here: present, place, queen
heritage: past, tradition, attribute
hero: man, courage, strength
hers: up, that, there
herself: up, that, there
hesitate: pause, hold, back
hey: up, that, there
hi: expression, state, central
hidden: prevent, go, keep
hide: skin, animal, large
high: level, position, degree
highlight: interesting, part, area
highly: high, degree, much
highway: major, road, form
hill: local, land, structure
him: under, leave, now
himself: up, could, that
hint: suggestion, slight, indication
hip: either, side, body
hire: newly, employee, act
his: mouth, music, leave
hispanic: whose, first, language
historian: person, authority, history
historic: important, famous, past
historical: study, history, place
historically: throughout, history, respect
history: past, record, narrative
hit: successful, stroke, athletic
hockey: game, ice, open
hold: act, understanding, nature
hole: opening, something, deliberately
holiday: time, away, work
holy: sacred, place, associated
home: live, particular, time
homeland: country, born, up
homeless: someone, unfortunate, without
homework: school, work, outside
honest: cheat, without, true
honey: sweet, yellow, liquid
honor: symbol, approval, distinction
hook: catch, door, sharp
hope: specific, instance, feeling
hopefully: manner, up, that
horizon: line, sky, appear
hormone: blood, tissue, specific
horn: loud, noise, blow
horrible: ugly, up, that
horror: intense, profound, fear
horse: since, buck, up
hospital: health, facility, receive
host: person, social, event
hostage: prisoner, one, party
hostile: troops, military, ill
hot: used, physical, high
hotel: building, pay, that
hour: period, time, equal
house: living, one, business
household: social, unit, living
housing: people, protective, cover
how: now, all, see
however: despite, anything, following
hug: tight, embrace, squeeze
huge: great, size, amount
huh: up, that, there
human: living, member, family
humanity: quality, human, world
humor: message, whose, verbal
hundred: ten, century, that
hunger: need, consequence, food
hungry: feeling, need, desire
hunt: painter, architect, hunting
hunter: someone, game, person
hunting: pursuit, killing, capture
hurricane: severe, tropical, usually
hurry: condition, necessary, eager
hurt: physical, damage, body
husband: married, partner, marriage
hypothesis: proposal, explain, certain
i: element, used, especially
ice: water, frozen, solid
icon: symbol, simple, program
idea: content, main, thing
ideal: idea, something, one
identical: exactly, perceived, different
identification: act, something, evidence
identify: recognize, establish, identity
identity: distinct, personality, individual
ideological: characteristic, orientation, thinking
ideology: orientation, thinking, group
if: anything, now, required
ignore: refuse, acknowledge, bar
ill: often, disorder, cause
illegal: law, official, up
illness: normal, function, part
illusion: mental, representation, something
illustrate: example, depict, illustration
illustration: make, something, clear
image: mental, representation, personal
imagination: formation, mental, image
imagine: form, mental, image
immediate: present, time, place
immediately: without, delay, time
immigrant: person, country, born
immigration: migration, place, country
immune: person, particular, infection
impact: striking, one, body
implement: piece, equipment, used
implementation: act, aim, order
implication: something, meaning, significance
imply: express, state, suggest
import: foreign, country, person
importance: quality, important, note
important: great, significance, value
importantly: important, way, degree
impose: compel, behave, certain
impossible: something, capable, up
impress: act, someone, government
impression: idea, confidence, appearance
impressive: strong, impression, effect
improve: make, better, get
improved: make, better, get
improvement: change, progress, development
impulse: motive, sudden, desire
in: unit, length, equal
inadequate: meet, task, sufficient
incentive: positive, influence, additional
inch: unit, length, equal
incident: single, distinct, event
include: consider, part, something
including: consider, part, something
income: financial, gain, given
incorporate: make, whole, part
increase: quantity, added, change
increased: become, amount, make
increasing: become, amount, make
increasingly: amount, intensity, up
incredible: beyond, belief, understanding
incredibly: easy, believe, extremely
indeed: truth, expression, surprise
independence: freedom, control, influence
independent: neutral, person, writer
index: scale, used, compare
indian: member, race, people
indicate: signal, symptom, either
indication: something, indicate, suggest
indicator: number, ratio, value
indigenous: found, up, that
individual: human, single, organism
industrial: industry, highly, developed
industry: people, particular, kind
inevitable: event, up, that
inevitably: manner, could, otherwise
infant: young, child, yet
infection: state, invasion, body
inflation: general, progressive, increase
influence: power, affect, especially
influential: influence, power, up
inform: knowledge, state, event
informal: formal, officially, intimate
information: message, knowledge, study
infrastructure: basic, structure, system
ingredient: component, mixture, compound
inherent: existing, essential, characteristic
inherit: obtain, someone, death
initial: first, letter, word
initially: beginning, up, that
initiate: someone, new, field
initiative: bold, new, first
injure: cause, harm, hurt
injury: physical, damage, body
inmate: one, several, resident
inn: hotel, overnight, up
inner: within, closer, center
innocent: person, knowledge, evil
innovation: creation, new, device
innovative: ahead, something, like
input: signal, electronic, system
inquiry: search, knowledge, instance
insect: small, person, nasty
insert: section, another, publication
inside: region, something, inner
insight: clear, deep, perception
insist: refuse, beg, assert
inspection: formal, official, examination
inspector: high, police, officer
inspiration: mind, special, unusual
inspire: supply, inspiration, urge
install: set, use, put
installation: act, something, building
instance: something, item, information
instant: short, time, eye
jet: airplane, one, sudden
instantly: without, delay, time
instead: place, alternative, rather
instinct: pattern, behavior, often
institute: association, organized, promote
institution: organization, united, specific
institutional: institution, organized, up
instruct: knowledge, give, task
instruction: message, something, knowledge
instructional: used, instruction, up
instructor: person, whose, occupation
instrument: device, skill, proper
insurance: promise, case, people
intact: nothing, essential, especially
integrate: make, whole, part
integrated: make, whole, part
integration: action, racial, religious
integrity: nothing, moral, unity
intellectual: person, mind, associated
intelligence: ability, understand, profit
intelligent: capacity, thought, reason
intend: mind, purpose, design
intense: distinctive, feature, degree
intensity: amount, energy, high
intent: outcome, meaning, communication
intention: outcome, goal, respect
interact: act, together, towards
interaction: mutual, transfer, energy
interest: sense, concern, curiosity
interested: curiosity, engage, interest
interesting: curiosity, engage, interest
interfere: come, obstacle, get
interior: region, inside, something
internal: within, especially, surface
international: several, concerning, least
internet: computer, network, worldwide
interpret: make, sense, assign
interpretation: mental, representation, meaning
interrupt: signal, execution, program
interval: length, time, two
intervention: act, policy, treatment
interview: person, conversation, information
intimate: someone, private, give
into: east, orbit, several
introduce: cause, come, know
introduction: act, beginning, something
invade: march, territory, military
invasion: act, army, up
invent: come, mental, effort
invention: creation, something, mind
inventory: detailed, list, stock
invest: make, investment, give
investigate: conduct, inquiry, investigation
investigation: inquiry, work, something
investigator: scientist, research, someone
investment: act, money, capital
investor: someone, capital, order
invisible: impossible, nearly, eye
invitation: request, participate, present
invite: expression, invitation, increase
involve: connect, closely, often
involved: connect, closely, often
involvement: act, group, connection
iraqi: native, people, culture
irish: people, up, that
iron: heavy, pure, form
ironically: plan, expectation, manner
irony: language, used, convey
islam: civilization, religion, religious
islamic: up, that, there
island: land, mass, water
isolate: place, set, apart
isolated: place, set, apart
isolation: state, separation, feeling
israeli: native, characteristic, people
issue: important, question, dispute
it: branch, engineering, use
italian: native, language, up
item: distinct, part, group
its: branch, engineering, use
itself: that, there, this
jacket: short, coat, outer
jail: institution, used, custody
japanese: native, language, up
jar: vessel, wide, mouth
jaw: part, skull, mouth
jazz: empty, rhetoric, talk
jeans: heavy, work, casual
jewelry: ring, precious, set
jewish: culture, religion, up
job: principal, activity, life
join: shape, manner, come
joint: point, connection, two
joke: remark, provoke, laughter
journal: daily, written, record
journalism: profession, reporting, news
journalist: writer, someone, diary
journey: act, one, place
joy: emotion, great, happiness
judge: public, official, decide
judgment: opinion, something, act
judicial: court, justice, appropriate
juice: liquid, part, plant
jump: sudden, increase, transition
jungle: location, intense, competition
junior: term, address, male
jurisdiction: right, power, interpret
juror: someone, jury, up
jury: body, give, true
just: used, especially, legally
justice: quality, fair, judgment
justify: show, reasonable, provide
keep: financial, means, one
key: metal, device, way
kick: act, blow, foot
kid: young, person, either
kill: act, life, destruction
killer: someone, death, person
killing: event, someone, die
kind: category, common, characteristic
king: male, kingdom, competitor
kingdom: domain, something, dominant
kiss: act, instance, cookie
kit: case, set, gear
kitchen: room, up, that
knee: joint, human, leg
kneel: rest, weight, up
knife: edge, tool, used
knock: sound, door, engine
know: fact, aware, information
knowledge: psychological, result, perception
known: aware, fact, specific
korean: native, language, up
lab: workplace, conduct, scientific
label: brief, description, given
labor: social, class, work
laboratory: workplace, conduct, scientific
lack: state, something, without
ladder: two, somebody, something
lady: name, woman, up
lake: body, water, land
lamp: artificial, source, visible
land: real, estate, material
landing: platform, structure, place
landmark: position, prominent, object
landscape: single, view, painting
lane: narrow, way, road
language: means, use, conventional
lap: upper, side, person
large: size, person, average
largely: large, mainly, scale
laser: light, emission, device
last: time, series, go
late: advanced, period, time
lately: recent, past, late
later: coming, subsequent, time
latin: language, ancient, up
latter: second, two, up
laugh: sound, expression, characteristic
laughter: sound, activity, joy
launch: open, deck, half
laundry: white, goods, workplace
law: collection, authority, legal
lawmaker: maker, someone, code
lawn: field, grass, up
lawsuit: comprehensive, term, court
lawyer: professional, person, practice
lay: narrative, song, poem
lieutenant: military, officer, police
life: characteristic, state, mode
layer: single, usually, substance
lead: advantage, competitor, race
leader: person, article, loss
leadership: activity, leading, body
leading: thin, strip, metal
leaf: main, organ, sheet
league: association, common, action
lean: property, line, surface
leap: movement, transition, jump
learn: gain, knowledge, get
learning: cognitive, process, skill
least: something, importance, used
leather: animal, skin, smooth
leave: period, time, work
lecture: speech, open, public
left: location, near, direction
leg: human, commonly, used
legacy: gift, personal, property
legal: upon, law, official
legally: law, legal, manner
legend: story, brief, description
legislation: law, legislative, body
legislative: legislature, legislation, up
legislator: someone, up, that
legislature: make, up, that
legitimate: make, legal, show
lemon: yellow, fruit, flesh
lend: quality, give, let
length: extent, space, one
lens: device, used, light
less: chronic, disease, tissue
lesson: unit, instruction, punishment
let: brutal, terrorist, group
letter: written, message, person
level: position, scale, intensity
liability: state, legally, responsible
liberal: person, political, philosophy
liberation: act, someone, something
liberty: exercise, political, independence
library: room, collection, literary
license: legal, document, official
lid: either, two, skin
lie: statement, truth, diplomat
lifestyle: manner, living, up
lifetime: period, something, functional
lift: act, temporary, assistance
light: radiation, produce, visual
lightly: without, good, reason
lightning: electric, cloud, earth
like: similar, kind, person
likelihood: outcome, up, that
likely: good, chance, case
likewise: like, similar, addition
limb: one, animal, used
limit: greatest, possible, degree
limitation: principle, extent, something
limited: public, transport, fast
line: formation, people, one
link: means, connection, series
lion: large, coat, male
lip: either, two, tissue
liquid: substance, room, temperature
list: database, array, property
listen: hear, intention, pay
listener: someone, up, that
literally: sense, without, up
literary: characteristic, literature, up
literature: creative, writing, artistic
little: small, amount, limited
live: lead, certain, kind
liver: large, complicated, organ
living: experience, course, human
load: weight, quantity, one
loan: temporary, provision, money
lobby: large, entrance, reception
local: public, transport, bus
locate: discover, location, determine
location: point, extent, space
lock: door, drawer, keep
log: segment, trunk, tree
logic: branch, philosophy, reasonable
logical: capable, capability, correct
lonely: alone, up, that
long: desire, strongly, primarily
longtime: long, up, that
look: face, act, toward
loop: metal, ring, small
loose: grant, freedom, free
lord: terms, person, general
lose: fail, keep, cease
loss: something, lost, decline
lost: people, die, soon
lot: large, number, amount
lots: large, number, amount
loud: sound, great, volume
love: strong, positive, emotion
lovely: pretty, girl, model
lover: person, someone, fan
low: air, mass, lower
lower: two, move, something
loyal: duty, love, country
loyalty: quality, loyal, commitment
luck: overall, condition, life
lucky: chance, good, fortune
lunch: meal, take, up
lung: either, two, chest
machine: mechanical, electrical, device
mad: sick, excited, crazy
magazine: publication, interest, purchase
magic: art, illusion, trick
match: thin, piece, wood
mate: officer, master, commercial
material: substance, makeup, physical
math: science, group, related
mathematics: science, group, related
matter: concern, situation, event
maximum: possible, quantity, greatest
may: month, following, small
magnitude: property, relative, size
mail: service, system, via
main: large, body, water
mainly: part, primarily, up
mainstream: current, thought, up
maintain: keep, certain, safety
maintenance: activity, involved, something
major: military, officer, lieutenant
majority: property, number, two
make: kind, act, gain
maker: person, terms, manufacturer
makeup: face, improve, change
male: animal, female, person
mall: public, area, set
mama: informal, terms, mother
man: adult, person, male
manage: achieve, goal, charge
management: act, something, charge
manager: someone, charge, training
mandate: document, official, instruction
manipulate: influence, control, hold
manner: something, way, fashion
mansion: one, equal, large
manufacturer: business, manufacturing, product
manufacturing: act, something, raw
many: used, count, often
map: representation, surface, part
marble: hard, rock, high
march: month, following, act
margin: boundary, line, area
marine: member, soldier, land
mark: number, letter, quality
marker: object, used, distinguish
market: world, commercial, activity
marketing: exchange, goods, sum
marketplace: world, commercial, activity
marriage: state, married, couple
married: person, take, marriage
marry: take, marriage, perform
mask: face, activity, something
mass: property, body, weight
massive: size, bulk, substance
master: artist, skill, person
maybe: chance, possibly, perhaps
mayor: head, city, government
me: state, leave, now
meal: food, one, time
mean: average, function, intend
meaning: message, idea, intend
meaningful: meaning, purpose, up
means: result, end, agency
meanwhile: time, one, period
measure: part, progress, toward
measurement: act, process, according
meat: flesh, used, food
mechanic: skilled, operating, machine
mechanical: concerned, up, that
mechanism: process, chemical, reaction
medal: award, championship, event
media: means, information, surrounding
medical: physical, variety, depending
medication: something, disease, act
medicine: medical, science, deal
medium: means, information, surrounding
meet: meeting, number, athletic
meeting: gathering, small, informal
melt: process, heat, something
member: one, compose, social
membership: body, organization, group
memorial: recognition, service, written
memory: something, cognitive, past
mental: mind, intellectual, process
mentally: mind, up, that
mention: remark, attention, something
mentor: wise, guide, serve
menu: list, available, restaurant
merchant: retail, trade, up
mere: small, pond, standing
merely: nothing, simply, but
merger: combination, two, commercial
merit: quality, attribute, deserve
mess: state, confusion, informal
message: communication, written, something
metal: several, chemical, usually
metaphor: figure, speech, expression
meter: basic, unit, length
method: way, especially, logical
metropolitan: title, given, position
mexican: native, up, that
middle: area, approximately, central
midnight: middle, night, up
midst: location, something, thick
might: physical, strength, power
migration: movement, one, country
mild: moderate, type, degree
mile: unit, length, equal
military: nation, study, assistance
militia: part, regular, army
milk: white, liquid, used
mill: plant, one, manufacturing
million: number, one, large
mind: responsible, seat, faculty
mine: earth, device, destroy
mineral: solid, nature, chemical
minimal: least, possible, minimum
minimize: make, small, represent
minimum: possible, quantity, point
minister: person, conduct, religious
ministry: religious, building, business
minor: young, person, either
minority: group, people, differ
minute: unit, time, equal
miracle: amazing, wonderful, event
mirror: surface, light, reflection
miss: young, woman, failure
missile: rocket, conventional, nuclear
missing: fail, perceive, catch
mission: organization, foreign, land
mistake: wrong, action, bad
mix: mixture, dry, event
mixed: mix, together, different
mixture: substance, two, mixed
mobile: river, port, fluid
mode: something, particular, condition
model: description, complex, entity
moderate: person, position, political
modern: contemporary, person, century
modest: opinion, large, sufficient
modify: make, less, severe
mom: informal, terms, mother
moment: particular, point, time
momentum: force, strength, product
money: common, medium, legal
monitor: someone, warning, mistake
monkey: various, one, up
monster: creature, usually, various
month: one, twelve, calendar
monthly: every, month, up
monument: structure, important, site
mood: characteristic, relatively, state
moon: natural, satellite, object
moral: significance, story, event
more: opposed, divorce, concept
moreover: addition, furthermore, up
morning: time, period, dawn
mortality: quality, state, ratio
mortgage: property, security, loan
most: used, count, often
mostly: large, mainly, rule
mother: woman, given, birth
motion: use, communicate, familiar
motivate: give, incentive, action
motivation: psychological, feature, organism
motive: psychological, feature, organism
motor: machine, energy, mechanical
mount: horse, act, something
mountain: land, mass, well
mouse: numerous, small, typically
mouth: opening, food, emerge
move: act, something, changing
movement: change, position, location
movie: form, entertainment, story
much: great, amount, extent
mud: water, soft, wet
multiple: product, quantity, one
municipal: characteristic, government, up
murder: killing, human, execution
muscle: one, body, animal
museum: scientific, historical, artistic
mushroom: common, name, related
music: artistic, form, communication
musical: play, film, whose
musician: someone, musical, instrument
muslim: up, that, there
must: necessary, essential, thing
mutual: common, shared, two
my: leave, after, now
myself: up, that, there
mysterious: import, apparent, obvious
mystery: something, understanding, story
myth: traditional, story, explain
nail: plate, part, surface
naked: completely, raw, bare
name: language, unit, person
narrative: message, act, course
narrator: someone, story, up
narrow: two, water, make
nasty: offensive, even, difficult
nation: politically, organized, body
national: person, nation, country
nationwide: throughout, country, nation
native: indigenous, person, born
natural: someone, certain, succeed
naturally: might, expected, according
nature: essential, something, agent
naval: used, navy, up
navy: organization, military, country
near: move, towards, far
nearby: close, hand, far
nearly: slightly, short, quite
neat: clean, organized, care
nor: up, could, that
necessarily: essential, manner, could
necessary: anything, absolutely, essential
necessity: condition, essential, anything
neck: part, organism, head
need: condition, relief, anything
needle: leaf, reading, scale
negative: reply, denial, piece
negotiate: discuss, terms, arrangement
negotiation: discussion, produce, agreement
neighbor: person, near, another
neighborhood: surrounding, nearby, region
neighboring: live, neighbor, near
neither: one, up, that
nerve: running, various, body
nervous: easily, anxiety, anxious
nest: structure, lay, give
net: computer, network, worldwide
network: system, people, communication
neutral: one, side, party
never: time, past, future
nevertheless: despite, anything, following
new: long, relatively, come
newly: recently, new, fresh
news: information, recent, important
newspaper: daily, weekly, publication
next: immediately, following, time
nice: city, leading, resort
night: time, sunset, dark
nightmare: situation, dream, deeply
nine: number, sum, eight
no: negative, element, carbon
nobody: person, influence, up
nod: sign, command, act
noise: sound, kind, experience
nominate: propose, candidate, honor
nomination: act, officially, candidate
nominee: politician, running, public
none: hour, day, up
nonetheless: despite, anything, following
nonprofit: organization, up, that
noon: middle, day, up
norm: standard, model, pattern
normal: something, example, norm
normally: normal, commonly, usually
north: region, line, northern
northeast: point, north, region
northern: developed, characteristic, region
northwest: region, direction, point
nose: organ, smell, entrance
not: word, group, used
note: brief, written, record
notebook: book, blank, recording
nothing: quantity, importance, degree
notice: announcement, information, sale
notion: idea, confidence, general
novel: extended, work, usually
now: present, historical, point
nowhere: place, up, that
nuclear: energy, release, up
number: property, sum, total
numerous: large, number, up
nurse: one, skilled, young
nut: usually, large, seed
nutrition: organic, process, organism
oak: hard, wood, used
object: visible, entity, cast
objection: act, opposition, protest
objective: goal, lens, system
obligation: social, force, action
observation: act, recording, measurement
observe: discover, determine, fact
observer: person, aware, expert
obstacle: something, way, must
obtain: come, possession, receive
obvious: easily, perceived, mind
obviously: often, used, apparently
occasion: event, critical, time
occasional: time, usually, casual
occasionally: up, that, there
occupation: principal, activity, life
occupy: keep, busy, live
occur: come, pass, suggest
ocean: large, body, water
odd: two, easily, funny
odds: likelihood, thing, rather
of: mouth, fool, south
off: kill, operation, hit
offender: person, moral, civil
offense: lack, failure, show
offensive: action, enemy, violate
offer: verbal, act, offering
offering: something, proposal, money
office: place, business, professional
officer: person, armed, position
official: worker, office, someone
officially: official, role, up
often: many, short, frequently
oh: state, north, central
oil: liquid, substance, water
ok: state, south, central
okay: give, approve, ok
old: past, phrase, especially
olympic: region, up, that
olympics: modern, ancient, every
on: operation, along, spit
once: one, occasion, soon
one: whole, number, single
ongoing: currently, up, that
onion: bulb, plant, worldwide
online: regular, route, railroad
only: single, isolated, exclusive
onto: up, that, there
open: clear, space, land
opening: open, empty, space
openly: open, way, up
opera: drama, set, commercial
operate: direct, perform, expected
operating: direct, perform, expected
operation: state, effect, business
operator: symbol, function, operation
opinion: personal, belief, judgment
opponent: someone, opposition, opposite
opportunity: possibility, due, favorable
oppose: express, opposition, fight
opposed: express, opposition, fight
opposite: word, meaning, opposed
opposition: action, something, disagree
opt: select, alternative, another
optimistic: best, possible, affirmative
option: right, buy, sell
or: state, room, hospital
oral: examination, communication, speech
orange: round, yellow, fruit
orbit: path, one, body
orchestra: musical, organization, group
order: command, given, superior
ordinary: judge, court, expected
organ: fully, structural, functional
organic: animal, vegetable, matter
organism: living, thing, ability
organization: group, people, work
organizational: organization, up, that
organize: create, cause, operating
organized: create, cause, operating
orientation: act, integrated, set
origin: place, something, beginning
original: creation, audio, something
originally: original, manner, reference
other: one, already, recently
otherwise: supposed, expected, differently
ought: up, that, there
ounce: unit, weight, equal
our: policy, capacity, under
ours: up, that, there
ourselves: up, that, there
out: failure, runner, reach
outcome: something, phenomenon, previous
outdoor: place, open, air
outer: outside, center, out
outfit: unit, military, company
outlet: place, business, goods
outline: line, object, summary
outlook: characteristic, mental, attitude
output: final, production, certain
outside: region, something, outer
outsider: someone, member, group
outstanding: quality, attention, spectacular
oven: kitchen, used, up
over: division, play, six
overall: work, clothing, shoulder
overcome: win, victory, get
overlook: high, place, good
overnight: operating, whole, night
oversee: watch, direct, manage
overwhelm: charge, someone, many
overwhelming: charge, someone, many
owe: pay, abstract, intellectual
own: ownership, possession, behalf
owner: someone, legal, business
ownership: relation, owner, thing
oxygen: element, normally, percent
pace: rate, walking, distance
pack: large, number, complete
package: collection, together, container
pad: number, paper, together
page: one, side, leaf
pain: symptom, physical, hurt
painful: physical, psychological, pain
paint: substance, used, protect
painter: artist, worker, cover
painting: art, artistic, composition
pair: set, two, similar
palace: large, mansion, group
pale: wooden, strip, part
palestinian: area, up, that
pan: cooking, wide, metal
panel: sheet, distinct, flat
panic: overwhelming, feeling, fear
pants: noise, short, steam
paper: material, mainly, wood
parade: including, people, extended
paradise: place, complete, delight
parent: father, one, birth
parental: generation, characteristic, parent
park: large, area, land
parking: space, act, vehicle
parliament: legislative, assembly, certain
part: something, relation, contribution
partial: function, two, respect
partially: partly, part, up
participant: someone, part, activity
participate: share, something, become
participation: act, group, condition
particle: tiny, piece, anything
particular: fact, part, opposed
particularly: extent, degree, common
partly: partially, part, up
partner: marriage, associate, activity
partnership: business, venture, contract
party: organization, gain, political
pass: advance, first, base
passage: act, passing, one
passenger: traveler, vehicle, boat
passing: play, one, player
passion: strong, feeling, emotion
past: time, period, life
pasta: dish, main, ingredient
pastor: person, conduct, religious
pat: sound, gentle, blow
patch: small, part, something
patent: document, sole, invention
path: course, conduct, way
patience: tolerance, delay, card
patient: person, medical, care
patrol: used, security, activity
patron: regular, customer, inn
pattern: structure, way, operation
pause: time, interval, temporary
pay: something, give, usually
payment: sum, money, claim
peace: state, absence, war
peaceful: war, response, up
peak: extreme, possible, amount
peanut: widely, plant, tropical
peasant: country, person, one
peel: politician, fruit, vegetable
peer: person, equal, standing
pen: writing, implement, point
penalty: act, payment, required
pencil: thin, writing, rod
pension: regular, payment, person
people: group, human, body
pepper: dark, red, fully
perceive: become, aware, conscious
perceived: become, aware, conscious
percent: proportion, relation, whole
percentage: proportion, relation, whole
perception: representation, basic, component
perfect: used, action, make
perfectly: completely, without, used
perform: carry, action, function
performance: dramatic, musical, entertainment
performer: dramatic, musical, work
perhaps: chance, possibly, maybe
period: amount, time, interval
permanent: series, hair, heat
permission: approval, something, act
permit: legal, document, official
persian: native, language, ancient
persist: continue, exist, refuse
person: human, body, including
personal: short, newspaper, article
personality: complex, emotional, characterize
personally: person, up, that
personnel: group, people, willing
perspective: way, regarding, appearance
persuade: win, approval, support
pet: animal, special, one
phase: distinct, time, period
phenomenon: state, process, known
philosophical: philosophy, attitude, meeting
philosophy: belief, system, group
phone: electronic, equipment, sound
photo: representation, person, scene
photograph: representation, person, scene
photographer: someone, up, that
photography: act, process, up
phrase: expression, one, sentence
physical: body, mind, spirit
physically: physical, up, that
physician: medical, practitioner, doctor
physics: science, matter, energy
piano: instrument, cause, strike
pick: person, thing, quantity
pickup: light, truck, open
picture: visual, representation, object
pie: dish, pan, often
piece: separate, part, whole
pig: domestic, person, cop
pile: collection, top, large
pill: something, medicine, shape
pillow: support, head, person
pilot: someone, operate, aircraft
pin: piece, jewelry, onto
pine: tree, often, white
pink: light, shade, red
pioneer: someone, open, new
pipe: tube, small, bowl
pit: hole, surface, stone
pitch: property, sound, variation
pitcher: person, open, vessel
pizza: open, pie, thin
place: point, respect, surface
placement: property, way, something
plain: extensive, level, open
plan: series, arrangement, scheme
plane: aircraft, fixed, wing
planet: nine, large, solar
planner: person, notebook, recording
planning: act, program, course
plant: industrial, labor, living
plastic: name, certain, used
plate: base, rubber, must
platform: surface, document, political
play: dramatic, work, performance
player: person, skilled, game
playoff: final, competition, determine
plaza: public, square, room
plea: request, help, someone
plead: appeal, request, offer
pleasant: harmony, taste, behavior
please: give, pleasure, delight
pleased: give, pleasure, please
pleasure: fundamental, feeling, hard
plenty: full, supply, large
plot: secret, scheme, something
plunge: brief, swim, water
plus: useful, valuable, quality
pm: examination, dead, body
pocket: small, inside, bag
poem: composition, written, up
poet: writer, term, usually
poetry: literature, form, communication
point: element, position, extension
poke: tall, herb, small
pole: long, rod, wood
police: force, maintain, security
policeman: member, police, force
policy: plan, action, individual
political: characteristic, politics, social
politically: regard, social, authority
politician: leader, civil, administration
politics: social, gain, authority
poll: inquiry, public, opinion
pollution: state, natural, environment
pond: small, lake, pool
pool: water, small, lake
poor: people, without, wealth
pop: informal, term, probably
pope: head, poet, up
popular: great, especially, general
popularity: quality, widely, up
population: people, territory, state
porch: structure, building, often
pork: meat, domestic, pig
port: place, people, enter
portfolio: thin, case, loose
portion: something, relation, percentage
portrait: word, picture, appearance
portray: make, portrait, depict
pose: impress, artistic, sit
position: particular, portion, space
positive: primary, form, quality
possess: temporary, police, force
possession: act, property, anything
possibility: future, prospect, potential
possible: something, might, suitable
possibly: chance, degree, possible
post: position, someone, guard
poster: sign, public, place
pot: metal, cooking, vessel
potato: native, food, annual
potential: inherent, capacity, coming
potentially: possibility, actual, up
pound: basic, unit, money
pour: cause, run, move
poverty: state, little, money
powder: solid, substance, form
power: possession, influence, rate
powerful: great, power, force
practical: concerned, actual, use
practically: nearly, practical, manner
practice: way, operation, behavior
practitioner: someone, profession, up
praise: expression, approval, offering
pray: address, object, say
prayer: act, appeal, up
preach: deliver, argue, favor
precious: feeling, high, worth
precise: sharply, exact, accurate
precisely: precise, manner, just
predict: make, prediction, tell
prediction: act, statement, future
prefer: like, value, highly
preference: strong, favor, something
pregnancy: state, period, conception
pregnant: developing, within, body
preliminary: minor, match, main
premise: statement, true, conclusion
premium: payment, insurance, amount
preparation: activity, setting, order
prepare: make, ready, suitable
prescription: action, drug, available
presence: state, current, existence
present: period, time, continuous
presentation: activity, something, prize
preserve: domain, someone, reservation
presidency: tenure, president, office
president: executive, officer, firm
presidential: president, presidency, up
press: state, notice, attention
pressure: force, unit, area
presumably: reasonable, assumption, up
pretend: make, believe, intent
pretty: bad, fairly, somewhat
prevail: status, importance, true
prevent: keep, make, impossible
prevention: act, bar, up
previous: something, else, time
previously: time, formerly, up
price: property, material, worth
pride: feeling, personal, worth
priest: authority, perform, administer
primarily: part, primary, import
primary: preliminary, election, one
prime: number, factor, period
prince: male, member, royal
princess: female, member, royal
principal: original, amount, debt
principle: basic, true, used
print: text, publication, picture
prior: head, religious, next
priority: status, order, importance
prison: institution, trial, punishment
prisoner: person, especially, war
privacy: quality, presence, view
private: man, rank, particular
privately: private, concerned, person
privilege: special, advantage, benefit
prize: something, given, victory
pro: athlete, pay, argument
probably: considerable, without, much
problem: state, difficulty, question
procedure: particular, course, action
proceed: continue, move, travel
process: particular, course, action
processing: procedure, subject, process
processor: business, processing, agricultural
proclaim: declare, someone, up
produce: fresh, vegetable, market
producer: someone, something, presentation
product: sale, artifact, someone
production: act, process, something
productive: capable, ability, produce
productivity: quality, productive, power
profession: body, people, occupation
professional: person, one, athlete
professor: someone, member, faculty
profile: analysis, extent, something
profit: given, period, time
profound: intellectual, emotional, depth
program: series, system, meet
programming: setting, order, time
progress: improvement, growth, development
progressive: used, action, person
prohibit: command, forbid, up
project: piece, work, envision
projection: prediction, past, image
prominent: quality, attention, position
promise: verbal, commitment, one
promising: make, promise, commitment
promote: contribute, progress, growth
promotion: message, behalf, product
prompt: cue, given, performer
proof: evidence, establish, truth
proper: typical, thing, right
properly: right, manner, reason
property: something, possession, someone
proportion: magnitude, part, whole
proposal: something, proposed, plan
propose: make, declare, plan
proposed: make, declare, plan
proposition: statement, something, either
prosecution: institution, conduct, legal
prosecutor: government, official, criminal
prospect: possibility, future, success
protect: shield, damage, use
protection: activity, someone, something
protective: afford, protection, kind
protein: large, group, organic
protest: formal, declaration, objection
protocol: format, transmission, data
proud: feeling, pleasure, something
prove: found, establish, validity
provide: give, something, useful
provided: give, something, useful
provider: someone, whose, business
province: territory, one, administrative
provision: condition, activity, something
provoke: call, forth, appear
psychological: mental, emotional, opposed
psychologist: scientist, psychology, up
psychology: science, mental, life
public: people, general, whole
publication: copy, work, distribution
publicity: message, behalf, product
publicly: manner, accessible, openly
publish: put, print, prepare
publisher: firm, publishing, business
publishing: business, matter, sale
pull: act, force, move
pulse: sharp, wave, normal
pump: mechanical, device, fluid
punch: blow, fist, mixed
punish: impose, penalty, punishment
punishment: act, penalty, up
purchase: acquisition, something, payment
pure: free, kind, without
purple: color, status, royal
purpose: outcome, something, used
purse: container, used, money
pursue: carry, participate, involved
pursuit: act, effort, capture
push: act, force, order
put: option, sell, given
puzzle: particularly, problem, correct
qualify: prove, capable, meet
quality: essential, attribute, something
quantity: much, many, something
quarter: one, four, equal
quarterback: person, position, football
queen: female, colony, social
quest: search, alternative, cognitive
question: instance, subject, matter
questionnaire: form, set, people
quick: area, body, highly
quickly: rapid, little, delay
quiet: period, calm, weather
quietly: low, volume, little
quit: put, end, state
quite: degree, used, greatest
quote: mark, used, attribute
rabbit: various, family, long
race: competition, contest, speed
racial: related, people, characteristic
racism: one, race, superior
rack: framework, rib, section
radar: instrument, echo, pulse
radiation: energy, form, act
radical: two, together, single
radio: medium, communication, electronic
rage: feeling, intense, anger
rail: barrier, bar, short
railroad: line, commercial, organization
rain: water, atmosphere, fresh
raise: amount, salary, increased
rally: large, gathering, people
ranch: farm, large, land
random: plan, order, depending
range: area, something, power
rank: row, line, people
rape: plant, seed, crop
rapid: part, river, current
rapidly: rapid, quickly, up
rare: widely, especially, long
rarely: often, seldom, up
rat: various, similar, mouse
rate: magnitude, frequency, relative
rather: extent, sooner, instead
rating: value, something, act
ratio: relative, two, relation
rational: fraction, consistent, reason
raw: informal, terms, especially
reach: within, something, effective
react: show, response, reaction
reaction: process, one, idea
read: something, interpret, written
reader: person, reading, someone
readily: without, much, difficulty
reading: cognitive, process, understanding
ready: action, prepare, eating
real: rational, number, basic
realistic: aware, awareness, really
reality: determine, appear, state
realize: fully, aware, perceive
really: truth, fact, reality
realm: domain, something, dominant
rear: back, military, formation
reason: rational, motive, belief
reasonable: reason, sound, judgment
rebel: person, part, armed
rebuild: build, up, that
recall: request, manufacturer, product
receive: get, come, possession
receiver: set, radio, person
recent: approximately, last, new
recently: recent, past, late
reception: manner, something, formal
recession: state, economy, widespread
recipe: something, formula, up
recipient: person, something, role
recognition: state, quality, process
recognize: accept, power, authority
recommend: push, something, express
recommendation: something, course, person
record: anything, document, permanent
recording: signal, something, picture
recover: get, find, use
recovery: return, original, state
recruit: recently, soldier, new
red: color, blood, loss
reduce: cut, make, reduction
reduction: act, something, process
refer: make, reference, relevant
reference: remark, attention, something
reflect: bring, back, deeply
reflection: intent, consideration, phenomenon
reform: change, better, result
refrigerator: white, goods, food
refuge: safe, place, something
refugee: safety, up, that
refuse: food, show, towards
regain: get, find, recover
regard: detail, point, particular
regarding: deem, look, affect
regardless: without, due, thought
regime: organization, authority, political
region: extended, location, something
regional: characteristic, region, related
register: official, written, record
regret: associated, wrong, disappointment
regular: patron, soldier, army
regularly: regular, manner, form
regulate: fix, adjust, rate
regulation: rule, principle, condition
regulator: various, fluid, official
regulatory: according, up, that
rehabilitation: someone, useful, place
reinforce: make, strengthen, support
reject: person, thing, set
relate: make, logical, connection
related: make, logical, connection
relation: characteristic, two, together
relationship: relation, often, used
relative: person, related, blood
relatively: relative, comparison, something
relax: become, less, take
release: sale, public, record
relevant: connection, subject, issue
reliability: quality, reliable, up
reliable: trust, true, honest
relief: feeling, something, condition
relieve: provide, physical, pain
religion: strong, belief, power
religious: member, order, poverty
reluctant: something, custom, become
rely: confidence, faith, swear
remain: stay, certain, state
remaining: stay, remain, certain
remark: statement, personal, opinion
remarkable: unusual, striking, notice
remember: recall, knowledge, keep
remind: put, mind, someone
resort: hotel, area, frequently
resource: available, source, new
respect: detail, point, condition
reminder: message, remember, something
remote: device, used, control
removal: act, office, up
remove: degree, distance, something
render: substance, similar, exclusively
rent: payment, series, owner
rental: property, let, act
repair: act, something, working
repeat: event, perform, echo
repeatedly: several, time, up
replace: person, thing, broken
replacement: act, equivalent, person
reply: statement, question, request
report: written, document, individual
reportedly: according, information, up
reporter: person, news, up
reporting: news, radio, television
represent: take, place, equivalent
representation: presentation, mind, form
representative: person, advocate, someone
republic: political, system, supreme
republican: member, advocate, republic
reputation: state, high, honor
request: formal, message, something
require: proper, consider, request
required: require, proper, consider
requirement: required, activity, anything
rescue: recovery, loss, danger
research: investigation, establish, search
researcher: scientist, research, investigator
resemble: appear, similar, bear
reservation: district, particular, purpose
reserve: manner, something, back
residence: address, official, house
resident: someone, particular, place
residential: used, residence, limited
resign: leave, give, retire
resist: especially, way, stand
resistance: action, something, disagree
resolution: formal, expression, vote
resolve: trait, formal, expression
respectively: order, given, up
respond: show, response, reaction
respondent: divorce, someone, up
response: result, process, due
responsibility: social, force, action
responsible: responsibility, agent, cause
rest: something, left, away
restaurant: building, people, go
restore: return, original, condition
restrict: place, limit, access
restriction: principle, extent, something
result: phenomenon, previous, effect
resume: short, summary, academic
retail: goods, usually, small
retailer: merchant, goods, retail
retain: hold, back, within
retire: go, stop, work
retired: go, stop, work
retirement: state, retired, business
retreat: withdrawal, troops, favorable
return: document, tax, collector
reveal: make, visible, known
revelation: speech, act, something
revenue: entire, amount, income
reverse: relation, direct, opposition
review: new, evaluation, essay
revolution: change, thinking, government
revolutionary: radical, supporter, political
reward: payment, return, service
rhetoric: language, effectively, please
rhythm: basic, unit, piece
rib: support, animal, bone
ribbon: long, object, thin
rice: used, food, either
rich: people, wealth, material
rid: relieve, free, up
ride: journey, vehicle, mechanical
rider: traveler, actively, animal
ridiculous: silly, up, that
rifle: shoulder, long, barrel
right: abstract, idea, due
rigid: compromise, flexibility, stiff
rim: shape, edge, less
ring: characteristic, sound, shape
riot: public, act, violence
rip: man, society, opening
rise: growth, strength, number
risk: source, possibility, loss
risky: risk, danger, safe
ritual: practice, procedure, religious
rival: hope, defeat, equal
river: large, natural, stream
road: open, way, travel
robot: mechanism, move, automatically
rock: mass, hard, mineral
rocket: vehicle, engine, jet
rod: long, thin, implement
role: required, expected, person
roll: motion, object, around
rolling: deep, sound, large
roman: resident, modern, ancient
romance: relationship, two, exciting
romantic: artist, someone, up
roof: protective, top, building
room: area, within, building
root: usually, organ, water
rope: strong, line, street
rough: part, golf, course
roughly: fairly, close, correct
round: charge, single, shot
route: line, travel, access
routine: method, procedure, short
routinely: according, routine, practice
row: arrangement, people, side
royal: sail, set, next
rub: obstacle, act, scratch
rubber: material, variety, various
ruin: state, destruction, building
rule: principle, condition, behavior
ruling: reason, judgment, opposed
rumor: mixture, truth, around
run: score, baseball, runner
runner: someone, without, foot
running: play, player, carry
rural: living, characteristic, country
rush: act, manner, sudden
russian: native, language, official
sack: bag, paper, plastic
sacred: concerned, religion, religious
sacrifice: act, something, penalty
sad: make, feel, sorry
safe: safely, secure, safety
safely: safe, manner, up
safety: state, certain, agent
sail: large, piece, fabric
salad: food, either, plate
salary: something, pay, wage
sale: particular, instance, general
salmon: various, large, food
salt: compound, acid, metal
same: member, indigenous, people
sample: small, part, something
sanctions: formal, explicit, approval
sand: loose, material, rock
sandwich: two, bread, make
satellite: equipment, around, earth
satisfaction: one, expectation, up
satisfy: meet, make, happy
sauce: food, behave, towards
save: act, opposition, harm
savings: fund, money, put
say: chance, speak, express
scale: reference, standard, relative
scan: act, examination, region
scandal: private, people, event
scare: sudden, mass, fear
scared: cause, fear, lose
scary: fear, terror, up
scatter: distribution, act, dust
scenario: outline, play, literary
scene: place, action, incident
scent: distinctive, pleasant, left
schedule: organized, plan, list
scheme: elaborate, plan, action
scholar: person, someone, long
scholarship: financial, aid, provided
school: educational, institution, building
science: particular, branch, scientific
scientific: practice, science, used
scientist: person, advanced, knowledge
scope: area, something, power
score: number, letter, quality
scout: person, keep, watch
scramble: struggle, way, beat
scratch: area, skin, depression
scream: sharp, cry, noise
screen: white, surface, protective
screening: display, motion, picture
screw: someone, simple, machine
script: written, version, play
scrutiny: act, something, closely
sculpture: work, plastic, art
sea: division, ocean, large
seal: composition, plastic, used
search: activity, thoroughly, order
season: period, year, special
seat: space, theater, train
second: basic, unit, time
secondary: defensive, football, line
secret: something, remain, hidden
secretary: person, head, administrative
section: part, composition, thin
sector: plane, figure, two
secular: someone, professional, person
secure: get, special, effort
security: state, free, danger
see: seat, within, perceive
seed: small, hard, fruit
seek: movement, head, specific
seem: give, certain, impression
seemingly: apparently, up, that
segment: one, several, fit
seize: take, hold, grab
seldom: often, rarely, up
select: pick, choose, number
selection: act, choice, survival
self: consciousness, identity, person
sell: activity, someone, buy
seller: someone, goods, money
seminar: meeting, exchange, course
senate: assembly, high, legislative
senator: member, senate, up
send: cause, go, somewhere
senior: undergraduate, student, year
sensation: elementary, awareness, someone
sense: general, conscious, awareness
sensitive: someone, living, dead
sensitivity: external, faculty, sensation
sentence: string, language, final
sentiment: feeling, emotion, personal
separate: article, originally, publication
separation: state, unity, coming
sequence: arrangement, follow, logical
sergeant: several, officer, rank
series: similar, order, one
serious: concerned, work, important
seriously: serious, manner, severe
servant: person, working, service
serve: stroke, ball, play
service: work, one, person
serving: individual, quantity, food
session: meeting, execution, time
set: group, kind, belong
setting: context, environment, something
settle: long, wooden, bench
settlement: body, people, settle
seven: number, sum, six
seventh: position, seven, series
several: count, number, many
severe: extremely, bad, degree
severely: severe, serious, degree
sex: associated, sexual, either
sexual: sexuality, sex, intimate
sexuality: distinguish, basis, sex
sexually: respect, sexuality, sexual
sexy: sexual, desire, interest
shade: relative, darkness, light
shadow: shade, within, clear
shake: building, material, used
shall: that, there, this
shallow: stretch, water, make
shame: painful, emotion, awareness
shape: arrangement, something, distinct
share: due, individual, person
shared: common, use, share
shareholder: someone, stock, corporation
shark: numerous, mostly, marine
sharp: musical, one, half
sharply: aggressive, manner, well
she: used, anything, kitchen
shed: single, used, shelter
sheep: usually, related, goat
sheer: turn, change, direction
sheet: broad, thin, surface
shelf: support, surface, mountain
shell: metal, charge, large
shelter: structure, privacy, protection
sheriff: principal, officer, county
shield: protective, structure, arm
shift: event, something, without
shine: quality, bright, light
ship: vessel, transport, send
shirt: upper, half, body
shit: terms, behavior, damn
shock: feeling, something, bad
shoe: fit, foot, flexible
shoot: new, branch, act
shooting: act, killing, someone
shop: establishment, retail, sale
shopping: goods, home, give
shore: land, along, edge
short: location, baseball, field
shortage: property, amount, something
shortly: short, time, near
shorts: end, knee, short
shot: act, solid, missile
should: come, that, there
shoulder: part, body, neck
shout: loud, often, protest
shove: act, push, someone
show: act, publicly, something
shower: water, standing, up
shrimp: terms, small, people
shrink: physician, loss, contract
shrug: gesture, raise, indicate
shut: move, opening, passage
shuttle: equipment, ball, rubber
shy: quick, throw, start
sibling: brother, sister, up
sick: people, stomach, mouth
side: place, within, region
sidewalk: walk, area, usually
sigh: sound, like, person
sight: instance, visual, perception
sign: indication, something, immediately
signal: action, gesture, message
signature: name, written, style
significance: quality, significant, meaning
significant: important, effect, meaning
significantly: significant, way, manner
silence: state, silent, one
silent: absence, sound, speak
silk: fabric, fine, certain
silly: word, used, ridiculous
silver: soft, white, precious
similar: alike, like, under
similarity: quality, similar, principle
similarly: like, similar, likewise
simple: plant, person, intelligence
simply: nothing, absolutely, just
simultaneously: instant, up, that
sin: god, act, hell
since: that, there, this
sing: deliver, produce, voice
singer: person, improved, machine
single: base, hit, safely
sink: water, basin, fixed
sister: female, person, another
sit: often, without, specific
site: piece, land, something
situation: general, state, combination
six: number, sum, five
sixth: position, six, series
size: physical, magnitude, something
skeptical: especially, religion, given
skill: ability, training, produce
skilled: special, skill, up
skin: natural, protective, body
skip: mistake, cut, jump
skirt: cloth, part, waist
skull: head, up, that
sky: atmosphere, outer, space
slam: one, bridge, noise
slap: blow, flat, object
slave: person, someone, hard
slavery: state, control, another
sleep: natural, state, rest
sleeve: part, cloth, arm
slice: share, something, serving
slide: small, flat, piece
slight: act, expression, anger
slightly: small, degree, extent
slip: socially, act, minor
slope: formation, property, line
slot: position, construction, variety
slow: lose, move, slowly
slowly: without, speed, sometimes
small: part, back, size
smart: kind, pain, wound
smell: sensation, nose, particular
smile: expression, usually, pleasure
smoke: cloud, fine, gas
smoking: act, tobacco, hot
smooth: act, make, shine
snake: person, up, that
snap: act, object, spell
sneak: person, someone, usually
snow: form, ice, layer
so: fifth, note, musical
soak: process, consequence, water
soap: agent, vegetable, animal
soar: act, air, rise
soccer: football, game, two
social: party, people, promote
socially: respect, society, social
society: extended, social, group
sock: cloth, inside, ankle
sodium: soft, element, metal
sofa: seat, one, person
soft: readily, pressure, weight
softly: low, volume, manner
software: written, associated, operation
soil: state, part, surface
solar: sun, up, that
soldier: man, woman, army
sole: golf, club, lean
solely: without, involved, entirely
solid: matter, room, temperature
solution: mixture, two, frequently
solve: find, solution, problem
some: used, either, mass
somebody: human, someone, soul
someday: time, future, up
somehow: way, means, reason
someone: human, soul, person
something: that, else, there
sometime: prior, time, former
sometimes: certain, always, used
somewhat: small, degree, extent
somewhere: unknown, location, used
son: male, human, divine
song: short, musical, composition
soon: near, future, shortly
sooner: native, resident, rather
sophisticated: make, less, natural
sorry: feeling, regret, sense
sort: category, common, characteristic
soul: part, cause, individual
sound: particular, effect, given
soup: liquid, food, especially
source: place, something, document
south: region, line, southern
southeast: point, south, region
southern: characteristic, region, south
southwest: point, south, region
soviet: council, communist, country
space: everything, empty, area
spanish: language, people, up
spare: extra, component, machine
spark: flash, light, trip
speak: express, speech, exchange
speaker: someone, public, speech
special: offering, temporary, advertising
specialist: expert, one, occupation
specialize: become, focus, area
specialty: asset, special, worth
species: group, whose, specific
specific: fact, part, opposed
specifically: distinction, up, that
specify: condition, requirement, contract
spectacular: performance, appearance, effect
spectrum: array, emission, wave
speculate: believe, especially, uncertain
speculation: message, opinion, evidence
speech: act, formal, communication
speed: distance, unit, time
spell: psychological, state, time
spend: pass, time, specific
spending: act, money, amount
sphere: particular, environment, walk
spill: liquid, channel, water
spin: motion, act, rapidly
spirit: vital, principle, force
spiritual: kind, religious, song
spit: narrow, strip, land
spite: feeling, need, see
split: right, trunk, front
spokesman: male, up, that
sponsor: someone, something, advocate
spoon: piece, shallow, container
sport: active, physical, competition
spot: point, respect, surface
spouse: partner, marriage, mate
spray: quantity, small, flying
spread: process, result, wide
spring: season, growth, metal
sprinkle: light, shower, nearby
spy: secret, agent, state
squad: army, unit, cooperative
square: plane, four, equal
squeeze: act, firmly, state
stability: quality, attribute, firm
stable: farm, building, housing
stack: pile, large, number
stadium: large, structure, bowl
staff: personnel, assist, superior
stage: distinct, time, period
stair: support, place, rest
stake: right, legal, share
stance: standing, mental, attitude
stand: support, foundation, position
standard: basis, reference, point
standing: social, financial, professional
star: body, hot, energy
stare: fixed, look, open
start: beginning, anything, time
starter: electric, motor, starting
starting: turn, starter, game
state: territory, one, administrative
statement: message, communication, setting
station: facility, special, equipment
statistical: statistics, up, that
statistics: branch, mathematics, concerned
statue: sculpture, human, animal
status: relative, position, standing
statute: act, legislative, body
stay: continuing, remaining, place
steadily: steady, rate, pace
steady: person, another, regular
steak: slice, meat, cut
steal: purchase, instance, base
steam: water, temperature, atmosphere
steel: iron, small, widely
steep: place, devote, fully
steer: indication, potential, opportunity
stem: form, word, structure
step: part, progress, toward
stereotype: conventional, conception, image
stick: implement, length, wood
stiff: ordinary, man, dead
still: photograph, one, movie
stimulate: act, cause, manner
stir: prominent, news, event
stock: capital, corporation, issue
stomach: organ, principal, belly
stone: mass, hard, mineral
stop: event, something, act
storage: act, something, goods
store: establishment, retail, sale
storm: violent, weather, condition
story: message, act, course
stove: kitchen, used, cooking
straight: someone, sexual, orientation
straighten: make, straight, up
strain: physical, body, action
strange: definitely, ordinary, slightly
stranger: anyone, belong, environment
strategic: concerned, strategy, highly
strategy: elaborate, plan, action
straw: plant, fiber, used
streak: series, distinctive, characteristic
stream: natural, body, running
street: including, part, travel
strength: property, physically, mentally
strengthen: make, strong, gain
stress: relative, musical, note
stretch: large, distance, act
strict: standard, rigid, up
strictly: something, manner, up
strike: work, protest, low
striking: physical, coming, together
string: cord, bow, train
strip: relatively, long, narrow
stroke: act, striking, ball
strong: strength, power, average
strongly: strength, strong, manner
structural: especially, political, economic
structure: thing, complex, entity
struggle: attempt, achieve, something
student: educational, institution, person
studio: workplace, teaching, practice
study: detailed, critical, inspection
stuff: substance, makeup, physical
stumble: trip, hit, up
stupid: person, bright, lack
style: something, way, language
subject: matter, conversation, discussion
submit: refer, judgment, consideration
subsequent: following, time, order
subsidy: grant, government, enterprise
substance: real, physical, matter
substantial: fairly, large, firm
substantially: great, extent, degree
subtle: difficult, detect, grasp
suburb: residential, district, city
suburban: characteristic, up, that
succeed: success, reach, goal
success: event, purpose, successful
successful: favorable, outcome, up
successfully: successful, manner, up
such: extreme, degree, extent
suck: act, draw, mouth
sudden: without, warning, short
suddenly: quickly, without, warning
sue: writer, whose, side
suffer: undergo, stomach, sustain
suffering: state, pain, stomach
sufficient: quantity, need, requirement
sugar: white, used, essential
suggest: make, declare, plan
suggestion: idea, proposal, acceptance
suicide: act, killing, person
suit: set, including, jacket
suitable: occasion, use, especially
suite: musical, composition, several
sum: quantity, money, addition
summary: brief, statement, main
summer: season, northern, period
summit: level, degree, stage
sun: star, source, light
swim: act, travel, water
sunlight: sun, up, that
sunny: bright, feeling, cheer
sunset: time, evening, sun
super: apartment, owner, rent
superior: one, rank, station
supermarket: large, grocery, store
supervisor: one, charge, direction
supplier: someone, whose, business
supply: amount, something, available
support: activity, money, cause
supporter: person, politician, team
supportive: support, assistance, up
suppose: express, say, speculate
supposed: express, suppose, alleged
supposedly: case, up, that
supreme: final, last, life
sure: feeling, doubt, confident
surely: definitely, sometimes, used
surface: outer, boundary, artifact
surgeon: physician, surgery, up
surgery: branch, medical, science
surprise: feel, something, totally
surprised: cause, come, upon
surprising: cause, surprised, come
surprisingly: surprising, manner, amazing
surround: area, something, extend
surrounding: extend, completely, fence
survey: detailed, critical, inspection
survival: state, remaining, alive
survive: continue, live, existence
survivor: one, another, up
suspect: someone, suspicion, person
suspend: hang, freely, cause
suspicion: impression, something, might
suspicious: openly, expected, funny
sustain: extend, space, undergo
swallow: small, amount, liquid
swear: declare, true, bank
sweat: fluid, active, worry
sweater: upper, part, body
sweep: wide, scope, someone
sweet: one, modern, dish
swell: movement, surface, open
technical: pickup, truck, gun
technician: someone, whose, occupation
technique: practical, method, art
swimming: act, travel, water
swing: state, steady, action
switch: control, mechanical, electrical
sword: weapon, long, metal
symbol: sign, conventional, significance
symbolic: means, serving, visible
sympathy: support, loyal, agree
symptom: sensation, change, function
syndrome: complex, pattern, disease
system: work, entity, group
table: set, data, piece
tablespoon: much, hold, spoon
tackle: person, position, football
tactic: plan, particular, goal
tag: label, written, plastic
tail: part, body, especially
take: income, profit, sale
tale: message, act, course
talent: natural, person, unusual
talented: talent, up, that
talk: exchange, via, conversation
tall: size, person, great
tank: military, large, vessel
tap: sound, gentle, blow
tape: long, thin, piece
target: reference, point, shoot
task: piece, work, specific
taste: sensation, tongue, throat
tax: charge, person, property
taxpayer: someone, up, that
tea: water, light, meal
teach: coast, knowledge, learn
teacher: person, whose, occupation
teaching: profession, teacher, doctrine
team: cooperative, unit, two
teammate: fellow, member, team
tear: drop, clear, solution
teaspoon: much, hold, small
tech: school, teaching, mechanical
technological: scientific, industrial, progress
technology: practical, application, science
teen: age, teenager, adolescent
teenage: age, teen, adolescent
teenager: teen, adolescent, up
telephone: electronic, equipment, sound
telescope: distant, crush, together
television: visual, system, distant
tell: early, century, skill
temperature: degree, body, environment
temple: place, flat, area
temporary: worker, basis, up
ten: number, sum, nine
tend: tendency, care, look
tendency: attitude, mind, especially
tender: something, used, official
tennis: game, two, four
tens: number, sum, nine
tension: state, mental, emotional
tent: shelter, canvas, ground
tenure: term, position, right
term: word, expression, used
terms: status, respect, people
terrain: piece, ground, specific
terrible: fear, terror, bad
terribly: used, terrible, manner
terrific: great, intense, good
territory: region, administrative, area
terror: overwhelming, feeling, fear
terrorism: use, violence, threat
terrorist: radical, terror, political
test: something, find, procedure
testify: give, testimony, court
testimony: statement, offering, fact
testing: act, experimental, test
text: something, written, passage
textbook: book, use, according
texture: feel, surface, fabric
than: anything, all, usual
thank: express, show, appreciation
thanks: appreciation, help, thank
thanksgiving: fourth, second, short
that: anything, recall, legislation
the: interview, recall, mouth
theater: building, art, writing
theatre: building, art, writing
their: use, hair, under
them: used, use, under
theme: subject, matter, conversation
themselves: that, there, this
then: moment, specific, prior
theology: rational, study, religion
theoretical: concerned, primarily, rather
theory: explanation, aspect, natural
therapist: person, skilled, particular
therapy: act, someone, medication
there: location, place, anything
thereby: means, up, that
therefore: introduce, logical, fact
these: used, under, use
they: used, anything, use
thick: location, something, specific
thigh: part, leg, hip
thin: lose, become, make
thing: special, situation, action
think: instance, thinking, judge
thinking: process, mind, consider
third: one, three, equal
thirty: number, product, ten
this: leave, context, after
thoroughly: manner, completely, absolutely
those: used, that, especially
though: however, that, there
thought: content, main, thing
thousand: number, product, quantity
thread: fine, cord, cotton
threat: something, source, danger
threaten: pose, threat, present
three: number, sum, one
threshold: starting, point, new
thrive: grow, make, steady
throat: passage, stomach, front
through: route, journey, continuing
throughout: first, last, used
throw: act, something, rapid
thumb: thick, short, part
thus: various, formerly, introduce
ticket: commercial, document, something
tide: rise, fall, sea
tie: long, narrow, piece
tiger: fierce, person, large
tight: closely, wet, nasty
tighten: make, tight, become
tightly: tight, manner, fixed
tile: flat, thin, clay
till: soil, sand, clay
timber: wood, cut, use
time: instance, single, occasion
timing: time, something, regulation
tiny: small, up, that
tip: extreme, end, especially
tired: lose, interest, become
tissue: part, organism, similar
title: statute, legislative, may
to: recall, mouth, after
tobacco: plant, dried, smoking
today: present, time, age
together: mentally, emotionally, stable
toilet: room, building, one
tolerance: power, capacity, organism
tolerate: put, something, somebody
toll: fee, use, value
tomato: acid, red, yellow
tomorrow: day, today, near
ton: unit, weight, equivalent
tone: quality, voice, pitch
tongue: mobile, mass, tissue
tonight: present, immediately, coming
too: degree, normal, proper
tool: implement, used, practice
tooth: hard, used, attack
top: upper, part, anything
topic: subject, matter, conversation
toss: act, coin, ball
total: whole, amount, quantity
totally: complete, degree, full
touch: event, something, coming
touchdown: score, possession, ball
tough: someone, fight, rather
tour: journey, route, way
tourism: business, up, that
tourist: someone, pleasure, up
tournament: competition, play, series
toward: attitude, policy, that
towards: attitude, up, that
towel: piece, cloth, wipe
tower: structure, stand, alone
town: urban, area, fixed
toxic: up, that, there
toy: artifact, something, else
trace: amount, indication, something
track: line, route, along
trade: commercial, exchange, domestic
trading: engage, trade, sell
tradition: pattern, thought, action
traditional: tradition, up, that
traditionally: according, traditional, manner
traffic: coming, particular, period
tragedy: event, great, loss
tragic: especially, grief, death
trail: track, mark, left
trailer: someone, time, behind
train: public, transport, provided
trainer: one, machine, ground
training: activity, leading, skilled
trait: feature, personal, nature
transaction: act, within, commercial
transfer: act, something, one
transform: subject, transformation, change
transformation: change, function, position
transit: instrument, vertical, small
transition: act, passing, one
translate: one, language, another
translation: written, communication, second
transmission: act, message, communication
transmit: transfer, another, serve
transport: something, means, transportation
transportation: facility, means, equipment
trap: device, something, drain
trash: material, people, ice
travel: act, one, place
traveler: person, location, up
tray: open, serving, food
treasure: wealth, form, money
treasury: government, institution, individual
treat: something, choice, eat
treatment: care, provided, improve
treaty: written, agreement, two
tree: tall, plant, main
tremendous: large, size, extent
trend: general, direction, something
trial: act, testing, something
tribal: characteristic, tribe, up
tribe: social, division, people
tribute: something, given, expression
trick: action, device, period
trigger: mechanism, gun, device
trim: state, arrangement, appearance
trip: journey, purpose, including
triumph: successful, struggle, contest
troops: group, parade, up
tropical: characteristic, region, either
trouble: source, difficulty, angry
truck: vehicle, suitable, frame
true: proper, property, something
truly: truth, fact, reality
trunk: main, stem, usually
trust: something, one, party
truth: fact, reality, accuracy
try: activity, accomplish, something
tube: long, object, used
tuck: position, close, chest
tumor: new, mass, tissue
tune: distinctive, sequence, property
tunnel: usually, one, hole
turn: segment, curve, act
twelve: number, sum, eleven
twentieth: position, series, coming
twenty: number, sum, one
twice: two, double, degree
twin: either, two, born
twist: development, interpretation, text
two: number, sum, one
type: particular, kind, thing
typical: identify, group, kind
typically: typical, manner, up
ugly: anger, bad, horrible
uh: up, that, there
ultimate: superior, quality, kind
ultimately: end, result, process
unable: necessary, means, skill
uncertain: lack, confidence, beyond
uncertainty: doubt, dependent, chance
uncle: brother, father, husband
uncomfortable: feeling, mental, physical
uncover: make, visible, remove
under: beneath, something, else
undergo: pass, up, that
undergraduate: university, student, yet
underlying: form, base, lie
undermine: destroy, property, normal
understand: know, nature, meaning
understanding: cognitive, condition, someone
undertake: enter, upon, activity
unemployment: state, job, up
unexpected: expected, up, that
unfair: up, that, there
unfold: develop, come, promising
unfortunate: person, ill, fortune
unfortunately: bad, luck, up
unhappy: feeling, up, that
uniform: clothing, distinctive, design
union: organization, bargain, employer
unique: distinctive, without, equal
unit: division, quantity, standard
unite: act, concert, common
united: act, concert, unite
unity: nothing, whole, number
universal: rule, found, proposition
universe: everything, anywhere, entire
university: body, faculty, establishment
unknown: region, anyone, belong
unless: up, that, there
unlike: equal, amount, different
unlikely: likely, true, occur
unprecedented: novel, up, that
until: up, that, finally
unusual: usual, common, ordinary
up: raise, position, former
update: news, information, bring
upon: attack, effect, come
upper: two, piece, leather
upset: unhappy, worried, mental
upstairs: part, building, ground
urban: concerned, city, area
urge: motive, strong, desire
us: republic, plus, northwest
use: act, something, used
used: put, make, work
useful: use, service, function
user: person, use, someone
usual: experienced, frequently, regular
usually: normal, normally, commonly
utility: company, public, subject
utilize: put, make, work
vacation: time, away, work
vaccine: dead, order, stimulate
valid: well, logic, truth
validity: quality, valid, legal
valley: long, depression, surface
valuable: something, value, great
value: quantity, quality, something
van: creative, group, active
vanish: get, without, warning
variable: something, likely, subject
variation: instance, rate, magnitude
variety: collection, sort, mixture
various: many, different, several
vary: become, different, particular
vast: great, size, amount
vegetable: numerous, plant, various
vehicle: people, medium, expression
vendor: someone, goods, money
venture: especially, one, uncertain
verbal: form, general, up
verdict: jury, fact, used
version: interpretation, matter, particular
versus: up, that, there
vertical: something, structural, member
very: precisely, exact, really
vessel: tube, body, fluid
veteran: considerable, active, service
via: up, that, there
vice: moral, weakness, specific
victim: unfortunate, person, circumstance
victory: successful, struggle, contest
video: visible, part, television
videotape: video, recording, tape
view: way, regarding, visual
viewer: close, someone, something
village: community, people, town
violate: fail, agree, violation
violation: crime, less, serious
violence: act, aggression, one
violent: great, force, energy
virtual: actually, almost, every
virtually: essence, effect, fact
virtue: quality, right, wrong
virus: agent, within, living
visible: capable, open, easy
vision: mental, image, ability
visit: act, see, person
visitor: someone, up, that
visual: sight, up, that
vital: absolutely, necessary, essential
vitamin: group, organic, essential
voice: distinctive, quality, pitch
volume: amount, space, object
voluntary: person, freely, service
volunteer: person, freely, service
vote: choice, number, people
voter: citizen, legal, right
voting: choice, number, people
vs: unit, potential, equal
vulnerable: attack, criticism, up
wage: something, carry, engage
wagon: various, animal, van
waist: body, narrow, part
wait: time, action, act
wake: event, island, western
walk: act, foot, advance
walking: act, foot, use
wall: height, length, used
wander: move, without, often
want: state, extreme, poverty
war: armed, conflict, enemy
warehouse: goods, store, up
warm: get, make, strong
warmth: sensation, heat, energy
warn: potential, risk, counsel
warning: message, danger, advice
warrior: someone, experienced, up
wash: thin, coat, paint
waste: consume, wild, blow
watch: small, period, time
water: compound, room, temperature
wave: one, series, across
way: something, result, end
we: used, use, spirit
weak: physical, strength, thin
weaken: strength, become, undermine
weakness: weak, point, act
wealth: state, rich, supply
wealthy: supply, money, value
weapon: instrument, used, fighting
wear: long, use, body
weather: comprise, state, atmosphere
weave: pattern, structure, fabric
web: network, something, trap
wedding: social, event, ceremony
weed: plant, black, band
week: period, seven, work
weekend: time, period, usually
weekly: every, week, seven
weigh: certain, weight, show
weight: vertical, force, mass
weird: fate, one, three
welcome: state, reception, receive
welfare: provision, economic, assistance
well: deep, hole, obtain
west: point, that, there
western: film, life, period
wet: water, cause, become
whale: large, impressive, size
what: use, now, all
whatever: one, every, without
wheat: annual, grass, flower
wheel: simple, machine, frame
when: used, bad, now
whenever: up, that, there
where: that, point, there
whereas: up, that, there
wherever: world, up, that
whether: that, any, there
which: organization, policy, under
while: period, length, action
whip: instrument, handle, flexible
whisper: softly, without, light
white: member, race, quality
who: agency, coordinate, international
whoever: up, that, there
whole: something, including, component
whom: up, that, there
whose: that, there, this
why: cause, intention, underlying
wide: great, extent, one
widely: great, degree, extent
wider: great, extent, one
widespread: widely, considerable, extent
widow: woman, whose, husband
wife: married, partner, marriage
wild: state, civilization, area
wilderness: state, region, near
wildlife: living, up, that
will: capability, conscious, choice
willing: act, choice, leave
willingness: compliance, up, that
win: victory, race, something
wind: air, considerable, area
window: framework, wood, metal
wine: juice, red, dark
wing: organ, flying, one
winner: contest, bet, success
winter: season, northern, spend
wipe: act, rub, motion
wire: metal, used, make
wisdom: knowledge, trait, experience
wise: way, leader, smart
wish: specific, feeling, desire
with: treaty, anything, concrete
withdraw: pull, back, move
withdrawal: previously, position, act
within: inside, up, that
without: regard, that, any
witness: someone, event, close
wolf: various, usually, hunt
woman: adult, female, person
wonder: feeling, something, strange
wonderful: good, great, used
wood: hard, substance, large
wooden: wood, ease, up
word: unit, language, native
work: activity, toward, something
worker: person, specific, occupation
working: mine, mental, physical
workout: activity, various, keep
workplace: place, work, up
workshop: small, workplace, manufacturing
world: everything, anywhere, people
worldwide: throughout, entire, world
worried: concerned, care, interest
worry: something, someone, source
worth: quantity, something, value
would: anything, use, administration
wound: injury, living, tissue
wow: joke, extremely, funny
wrap: around, person, sandwich
wrist: joint, end, row
write: produce, literary, work
writer: person, able, write
writing: act, written, work
written: produce, literary, work
wrong: justice, law, harm
yard: unit, length, equal
yeah: up, that, there
year: period, time, regular
yell: loud, often, protest
yellow: color, turn, chicken
yes: affirmative, up, that
yesterday: day, immediately, today
yet: present, time, used
yield: production, certain, amount
you: used, intend, use
young: animal, film, television
youngster: young, person, either
your: use, dog, clothes
yours: up, that, there
yourself: up, that, there
youth: young, person, man
zone: place, distinctive, surface
